Word	Truth
Appreciation	Common
Art	Proper
Insights	Common
Eye	Common
Tracking	Common
Claire	Proper
Bailey	Proper
Ross	Proper
claire.bailey-ross@port.ac.uk	Proper
University	Proper
Portsmouth	Proper
Kingdom	Proper
Andrew	Proper
Beresford	Proper
a.m.beresford@durham.ac.uk	Proper
Durham	Proper
Daniel	Proper
Smith	Proper
daniel.smith2@durham.ac.uk	Proper
Warwick	Proper
c.l.h.warwick@durham.ac.uk	Proper
people	Common
art	Common
elements	Common
artworks	Common
museum	Common
labels	Common
impact	Common
viewing	Common
experience	Common
one	Common
issues	Common
perception	Common
attention	Common
memory	Common
decision	Common
affect	Common
emotion	Common
time	Common
ways	Common
artwork	Common
relevance	Common
interestingness	Common
appeal	Common
paper	Common
pilot	Common
project	Common
collection	Common
Century	Common
Zurbarán	Proper
paintings	Common
Jacob	Proper
cycle	Common
Auckland	Proper
Castle	Proper
UK	Proper
example	Common
purpose	Common
surroundings	Common
studies	Common
psychology	Common
works	Common
distinctions	Common
topics	Common
work	Common
appreciation	Common
collections	Common
themes	Common
insights	Common
eye	Common
tracking	Common
techniques	Common
processes	Common
study	Common
effects	Common
interpretation	Common
exploration	Common
implications	Common
understanding	Common
behaviours	Common
gallery	Common
practice	Common
research	Common
strengths	Common
history	Common
humanities	Common
reactions	Common
representations	Common
significance	Common
whole	Common
interaction	Common
beginning	Common
scan	Common
viewer	Common
information	Common
series	Common
fixations	Common
movements	Common
saccades	Common
direction	Common
goals	Common
observer	Common
properties	Common
scene	Common
colour	Common
texture	Common
brightness	Common
etc	Common
insight	Common
participants	Common
beliefs	Common
memories	Common
impressions	Common
potential	Common
processing	Common
arts	Common
Brieber	Proper
Binderman	Proper
way	Common
factors	Common
visit	Common
Filippini	Proper
Fantoni	Proper
Heidenreich	Proper
Turano	Proper
Milekic	Proper
Sons	Common
display	Common
Long	Proper
Room	Common
years	Common
kind	Common
world	Common
scholarship	Common
Baron	Proper
aspects	Common
production	Common
stage	Common
audience	Common
County	Proper
Benjamin	Proper
copy	Common
Arthur	Proper
Pond	Proper
part	Common
audiences	Common
culture	Common
label	Common
characteristics	Common
visitor	Common
behaviour	Common
Introduction	Common
tenure	Common
track	Common
university	Common
faculty	Common
role	Common
speed	Common
progress	Common
training	Common
researchers	Common
efforts	Common
forms	Common
diversity	Common
gender	Common
community	Common
group	Common
thinking	Common
solutions	Common
tasks	Common
individuals	Common
skillsets	Common
perspectives	Common
abilities	Common
peers	Common
climates	Common
learning	Common
environments	Common
mentoring	Common
scientists	Common
science	Common
lack	Common
data	Common
workforce	Common
composition	Common
dynamics	Common
field	Common
computer	Common
step	Common
fields	Common
listing	Common
sample	Common
frame	Common
analysis	Common
rates	Common
adoption	Common
services	Common
GoogleScholar	Proper
ResearchGate	Proper
disciplines	Common
instance	Common
representation	Common
computing	Common
issue	Common
census	Common
degree	Common
inequality	Common
sources	Common
society	Common
membership	Common
roll	Common
hand	Common
organization	Common
lists	Common
web	Common
directories	Common
departments	Common
task	Common
samples	Common
elite	Common
generalizability	Common
date	Common
record	Common
business	Common
set	Common
light	Common
inequalities	Common
placement	Common
productivity	Common
snapshot	Common
system	Common
trends	Common
numbers	Common
aggregate	Common
Computing	Proper
Research	Proper
Association	Proper
CRA	Proper
employment	Common
PhD	Common
recipients	Common
Taulbee	Proper
survey	Common
North	Proper
America	Proper
cra.org/resources/taulbee-survey	Proper
surveys	Common
summary	Common
statistics	Common
weaknesses	Common
response	Common
misinterpretation	Common
questions	Common
frames	Common
bias	Common
analyses	Common
view	Common
causality	Common
differences	Common
recruitment	Common
retention	Common
strategies	Common
averaging	Common
efficacy	Common
policies	Common
crawler	Common
World	Proper
Wide	Proper
Web	Common
discipline	Common
hours	Common
shelf	Common
hardware	Common
improvement	Common
access	Common
listings	Common
societies	Common
effectiveness	Common
participation	Common
parallel	Common
movement	Common
labor	Common
flows	Common
advances	Common
availability	Common
design	Common
implementation	Common
framework	Common
results	Common
sections	Common
validity	Common
utility	Common
second	Common
type	Common
censuses	Common
pipeline	Common
problem	Common
Economics	Proper
Foundations	Common
Application	Proper
Case	Common
Property	Proper
Rights	Proper
Credibility	Common
State	Proper
Commitment	Common
half	Common
century	Common
return	Common
institutions	Common
awarding	Common
Nobel	Proper
Prize	Common
representatives	Common
Douglass	Proper
Ronald	Proper
Coase	Proper
Oliver	Proper
Williamson	Proper
Elinor	Proper
Ostrom	Proper
recognition	Common
notions	Common
approach	Common
concepts	Common
transaction	Common
costs	Common
transactions	Common
gains	Common
exchange	Common
place	Common
rules	Common
game	Common
structure	Common
economy	Common
incentives	Common
behavior	Common
level	Common
uncertainty	Common
property	Common
rights	Common
words	Common
agents	Common
actors	Common
objectives	Common
creation	Common
right	Common
equality	Common
conditions	Common
course	Common
state	Common
lead	Common
institution	Common
judiciary	Common
order	Common
climate	Common
cooperation	Common
violators	Common
contracts	Common
path	Common
disagreements	Common
elites	Common
consequences	Common
activity	Common
growth	Common
power	Common
number	Common
groups	Common
governments	Common
resources	Common
rest	Common
population	Common
enrichment	Common
being	Common
feature	Common
government	Common
interest	Common
pluralism	Common
loss	Common
privileges	Common
constitution	Common
action	Common
compliance	Common
mechanisms	Common
standards	Common
case	Common
expropriation	Common
YPF	Proper
decisions	Common
execution	Common
performance	Common
scenario	Common
enforcement	Common
mechanism	Common
FDI	Common
Structure	Common
policymaking	Common
knowledge	Common
country	Common
Argentina	Proper
era	Common
metropolis	Common
establishment	Common
politics	Common
actions	Common
citizens	Common
Rhythm	Common
Enjambment	Common
Detection	Common
Centuries	Common
Sonnets	Common
Pablo	Proper
Ruiz	Proper
Fabo	Proper
pabloruizfabo@gmail.com	Proper
Lattice	Proper
Lab	Proper
CNRS	Proper
France	Proper
Clara	Proper
Martínez	Proper
Cantón	Proper
cimartinez@flog.uned.es	Proper
Universidad	Proper
Nacional	Proper
de	Proper
Educación	Proper
a	Proper
Distancia	Proper
Spain	Proper
Thierry	Proper
Poibeau	Proper
thierry.poibeau@ens.fr	Proper
unit	Common
lines	Common
poetry	Common
Domínguez	Proper
Caparrós	Proper
rise	Common
emphasis	Common
phrase	Common
contrast	Common
interpretations	Common
García	Proper
Paje	Proper
configurations	Common
enjambment	Common
use	Common
authors	Common
overview	Common
others	Common
Quilis	Proper
Paraíso	Proper
Spang	Proper
description	Common
Alarcos	Proper
Senabre	Proper
Luján	Proper
Fernández	Proper
author	Common
scale	Common
hundreds	Common
centuries	Common
reading	Common
Moretti	Proper
need	Common
software	Common
Language	Proper
Processing	Common
Spanish	Proper
corpus	Common
sonnets	Common
literature	Common
debate	Common
units	Common
criteria	Common
object	Common
amounts	Common
examples	Common
evidence	Common
scholars	Common
claims	Common
Navarro	Proper
Age	Common
period	Common
abstract	Common
definition	Common
evaluation	Common
findings	Common
sonnet	Common
website	Common
details	Common
space	Common
reasons	Common
trend	Common
antiquity	Common
Parry	Proper
Homer	Proper
Flores	Proper
Gómez	Proper
tradition	Common
pause	Common
form	Common
end	Common
line	Common
hemistichs	Common
cut	Common
experiments	Common
word	Common
terms	Common
Phrase	Common
sequences	Common
noun	Common
adjective	Common
verb	Common
adverb	Common
antecedent	Common
pronoun	Common
clause	Common
site	Common
list	Common
types	Common
subject	Common
verbs	Common
reader	Common
effect	Common
cases	Common
expansion	Common
recitation	Common
typology	Common
typologies	Common
pollution	Common
Agents	Common
experts	Common
charlatans	Common
sense	Common
responsibility	Common
kinds	Common
selection	Common
pain	Common
regress	Common
fact	Common
markers	Common
expertise	Common
philosophers	Common
opportunity	Common
deception	Common
environment	Common
mimicry	Common
methods	Common
means	Common
pretense	Common
trust	Common
expert	Common
authority	Common
capacity	Common
public	Common
advantage	Common
health	Common
care	Common
doctors	Common
College	Proper
Pediatricians	Proper
ACPeds	Proper
viewpoints	Common
child	Common
debates	Common
forum	Common
college	Common
profession	Common
statement	Common
reassignment	Common
surgery	Common
consensus	Common
States	Proper
pediatricians	Common
peak	Common
body	Common
workers	Common
Academy	Proper
Pediatrics	Proper
dysphoria	Common
base	Common
range	Common
opinions	Common
views	Common
weight	Common
impression	Common
pollutant	Common
companies	Common
publishing	Common
giant	Common
Elsevier	Proper
publications	Common
peer	Common
journals	Common
products	Common
prestige	Common
air	Common
reliability	Common
deceit	Common
opposite	Common
legitimacy	Common
publication	Common
extension	Common
dissemination	Common
outbreak	Common
fee	Common
phenomenon	Common
times	Common
academia	Common
journal	Common
Frontiers	Proper
contingent	Common
profit	Common
motive	Common
Health	Proper
articles	Common
vaccines	Common
autism	Common
link	Common
HIV	Proper
AIDS	Proper
Jeffrey	Proper
Beall	Proper
publisher	Common
controversy	Common
judgments	Common
professionals	Common
academics	Common
difficulty	Common
publishers	Common
confidence	Common
board	Common
result	Common
conflicts	Common
reason	Common
occasions	Common
attempts	Common
systems	Common
function	Common
universities	Common
bar	Common
associations	Common
review	Common
bodies	Common
functions	Common
conflict	Common
pressures	Common
credentials	Common
incentive	Common
staff	Common
rankings	Common
grant	Common
money	Common
students	Common
Systems	Proper
manipulation	Common
Malaysia	Proper
metrics	Common
accusations	Common
fraud	Common
discoveries	Common
reputations	Common
Use	Common
Games	Proper
School	Proper
Contributions	Common
Attention	Common
Daniela	Proper
Karine	Proper
Ramos	Proper
dadaniela@gmail.com	Proper
Universidade	Proper
Federal	Proper
Santa	Proper
Catarin	Proper
Bruna	Proper
Anastacio	Proper
brunaanastacio@hotmail.com	Proper
games	Common
cognition	Common
intersection	Common
sets	Common
fun	Common
point	Common
process	Common
complaint	Common
parents	Common
teachers	Common
schools	Common
respect	Common
contributions	Common
influence	Common
skills	Common
Li	Proper
Polat	Proper
Scalzo	Proper
Bavelier	Proper
ability	Common
objects	Common
Dye	Proper
Feng	Proper
Spence	Proper
Pratt	Proper
Boot	Proper
Kramer	Proper
Simons	Proper
Fabiani	Proper
Gratton	Proper
school	Common
context	Common
student	Common
span	Common
preschool	Common
age	Common
Rueda	Proper
Checa	Proper
Cómbita	Proper
intelligence	Common
children	Common
Miller	Proper
Robertson	Proper
working	Common
Klingberg	Proper
Thorell	Proper
Lindqvist	Proper
Nutley	Proper
Bohlin	Proper
importance	Common
functioning	Common
involvement	Common
regulation	Common
thoughts	Common
emotions	Common
content	Common
distractors	Common
question	Common
classroom	Common
activities	Common
features	Common
challenges	Common
player	Common
quest	Common
Kirriemuir	Proper
McFarlane	Proper
Prensky	Proper
database	Common
Escola	Proper
do	Common
Cérebro	Proper
monitoring	Common
exercise	Common
problems	Common
approaches	Common
observation	Common
interventions	Common
interviews	Common
perceptions	Common
intervention	Common
D2	Common
Test	Common
scanning	Common
accuracy	Common
tablets	Common
weeks	Common
Basic	Proper
Education	Proper
Catarina	Proper
M	Common
participant	Common
control	Common
n	Common
test	Common
interval	Common
platform	Common
application	Common
visualization	Common
possibility	Common
Students	Common
scores	Common
variables	Common
stability	Common
t	Common
difference	Common
score	Common
p	Common
mean	Common
deviation	Common
dispersion	Common
variation	Common
relation	Common
addition	Common
interview	Common
preference	Common
solving	Common
improvements	Common
changes	Common
persistence	Common
tenet	Common
sound	Common
connection	Common
meaning	Common
dog	Common
English	Proper
concept	Common
accident	Common
French	Proper
German	Proper
Japanese	Proper
language	Common
portion	Common
sounds	Common
principles	Common
arbitrariness	Common
sign	Common
selectiveness	Common
languages	Common
likelihood	Common
exception	Common
rule	Common
comparison	Common
continents	Common
repair	Common
initiator	Common
support	Common
claim	Common
similarities	Common
interjection	Common
initiation	Common
chance	Common
coincidence	Common
globe	Common
dialects	Common
interjections	Common
item	Common
nature	Common
grunt	Common
signalling	Common
hearing	Common
Extract	Proper
NB	Proper
speaker	Common
G	Common
E	Common
repetition	Common
term	Common
sequence	Common
turn	Common
operation	Common
modification	Common
Extracts	Proper
Siwu	Proper
Kwa	Proper
Ghana	Proper
Lao	Proper
Tai	Proper
Kadai	Proper
Laos	Proper
Maize1_1017013	Proper
CONV_050815c_03.10	Proper
method	Common
Sequences	Common
Figure	Proper
recordings	Common
conversations	Common
phonology	Common
grammar	Common
comparability	Common
OIR	Proper
talk	Common
trouble	Common
surprise	Common
uses	Common
paths	Common
change	Common
Discussion	Common
adult	Common
SI	Proper
session	Common
format	Common
felicity	Common
truth	Common
value	Common
hypothesis	Common
variability	Common
some	Common
surface	Common
size	Common
items	Common
finding	Common
limitations	Common
LIMITATIONS	Common
DIRECTIONS	Common
reminder	Common
acquisition	Common
grouping	Common
millions	Common
Nedwick	Proper
Follow	Common
stimuli	Common
depictions	Common
region	Common
Africa	Proper
testing	Common
Hein	Proper
Reich	Proper
Marks	Proper
Thuma	Proper
Grigorenko	Proper
conclusions	Common
regard	Common
colleagues	Common
responses	Common
puppet	Common
pictures	Common
descriptions	Common
collectors	Common
default	Common
answer	Common
methodology	Common
outcomes	Common
puppets	Common
appearance	Common
arrival	Common
ranges	Common
Numbers	Common
communities	Common
Chitonga	Proper
borrowings	Common
Conclusion	Common
inference	Common
combination	Common
hierarchy	Common
Utilization	Common
CFL	Common
LED	Common
bulbs	Common
N	Proper
S	Proper
Andres	Proper
R	Proper
T	Common
Ponce	Proper
Engineering	Proper
Department	Proper
Bataan	Proper
Peninsula	Proper
Balanga	Proper
City	Proper
Philippines	Proper
Abstract	Common
Today	Proper
generation	Common
day	Common
help	Common
lighting	Common
night	Common
presence	Common
necessity	Common
Lighting	Common
consumption	Common
household	Common
energy	Common
home	Common
bulb	Common
Light	Proper
mercury	Common
Emission	Common
UV	Common
Radiation	Common
solution	Common
safety	Common
conservation	Common
diode	Common
SCLED	Common
chemicals	Common
Household	Proper
Energy	Proper
Consumption	Proper
Survey	Proper
HECS	Proper
electricity	Common
source	Common
households	Common
percent	Common
March	Proper
August	Proper
demand	Common
sectors	Common
appliances	Common
January	Proper
june	Proper
homes	Common
figure	Common
today	Common
sector	Common
efficiency	Common
usage	Common
perks	Common
perils	Common
lamp	Common
price	Common
CFLs	Common
start	Common
greenhouse	Common
emissions	Common
wastes	Common
ground	Common
water	Common
radiation	Common
inside	Common
skin	Common
UVR	Common
erythema	Common
sunburn	Common
vitamin	Common
D	Proper
Skin	Common
aging	Common
cancer	Common
exposure	Common
situation	Common
lights	Common
proponents	Common
compatibility	Common
materials	Common
Design	Common
Mutation	Proper
Operators	Proper
Information	Proper
Suilen	Proper
H.	Proper
Alvarado	Proper
Laboratorio	Proper
Bases	Proper
Datos	Proper
Campus	Proper
Elviña	Proper
Centro	Proper
investigación	Proper
CITIC	Proper
da	Proper
Coruña	Proper
A	Proper
s.hernandez@udc.es	Proper
XoveTIC	Proper
Congress	Proper
September	Proper
article	Common
mutation	Common
operators	Common
mutants	Common
applications	Common
Keywords	Common
technique	Common
errors	Common
System	Proper
SUT	Common
mutant	Common
technologies	Common
paradigms	Common
domains	Common
domain	Common
GIS	Common
programming	Common
development	Common
proof	Common
programmer	Common
Java	Proper
reflection	Common
aspect	Common
Reflection	Common
classes	Common
user	Common
operator	Common
ChangeCoordSys	Proper
Operator	Proper
Listing	Proper
coordinate	Common
geometry	Common
interface	Common
error	Common
wrapping	Common
technology	Common
places	Common
areas	Common
Geofences	Common
Geofence	Common
location	Common
latitude	Common
longitude	Common
radius	Common
device	Common
notifications	Common
map	Common
zones	Common
BooleanPolygonConstraint	Proper
geometries	Common
operations	Common
verification	Common
restrictions	Common
intersects	Common
covers	Common
overlap	Common
land	Common
objective	Common
reparcelling	Common
lands	Common
owner	Common
exploitation	Common
polygons	Common
Conclusions	Common
proposals	Common
Replication	Common
Reviews	Common
Recommendations	Common
Field	Common
endeavor	Common
procedures	Common
replication	Common
indication	Common
calls	Common
L2	Common
references	Common
commentaries	Common
Appendix	Common
S1	Proper
Santos	Proper
Polio	Proper
Gass	Proper
Vandergrift	Proper
Cross	Proper
book	Common
length	Common
treatment	Common
Porte	Proper
Instruments	Proper
Languages	Proper
IRIS	Proper
repository	Common
http://www.irisdatabase.org	Proper
purposes	Common
Marsden	Proper
Mackey	Proper
Plonsky	Proper
Science	Proper
Framework	Proper
https://osf.io	Proper
infrastructure	Common
collaboration	Common
Collaboration	Proper
waves	Common
Laws	Proper
Lindsay	Proper
Martin	Proper
Clarke	Proper
media	Common
Baker	Proper
Devlin	Proper
metascience	Common
Munafò	Proper
syntheses	Common
quantity	Common
education	Common
Makel	Proper
Plucker	Proper
force	Common
battery	Common
crisis	Common
concerns	Common
dimensions	Common
amount	Common
quality	Common
reproducibility	Common
extent	Common
core	Common
commentators	Common
gold	Common
standard	Common
Jasny	Proper
Chin	Proper
Chong	Proper
Vignieri	Proper
p.	Common
linchpin	Common
excitement	Common
originality	Common
Berez	Proper
Kroeker	Proper
Branco	Proper
Cohen	Proper
Vossen	Proper
Ide	Proper
Calzolari	Proper
Chambers	Proper
Schmidt	Proper
gap	Common
reviews	Common
subdomains	Common
sister	Common
relationship	Common
synthesis	Common
self	Common
replications	Common
piloting	Common
instrument	Common
discussion	Common
recommendations	Common
Morgan	Proper
Short	Proper
Faretta	Proper
Stutenberg	Proper
Williams	Proper
Liu	Proper
McManus	Proper
Heil	Proper
Botero	Proper
Moriaty	Proper
Ebert	Proper
premise	Common
refinement	Common
theory	Common
epistemologies	Common
constructs	Common
aim	Common
clarification	Common
Salinity	Common
parameters	Common
circulations	Common
biogeochemistry	Common
ocean	Common
drifters	Common
buoys	Common
cruises	Common
salinity	Common
regions	Common
resolution	Common
measurements	Common
decade	Common
launch	Common
soil	Common
moisture	Common
SMOS	Proper
satellite	Common
Space	Common
Agency	Proper
ESA	Proper
Aquarius	Proper
SAC-D	Proper
SMAP	Proper
Aeronautics	Proper
Administration	Proper
NASA	Proper
sea	Common
SSS	Common
observations	Common
sensing	Common
1970s	Common
Skylab	Proper
L	Proper
band	Common
radiometry	Common
microwave	Common
interferometers	Common
array	Common
radiometer	Common
ESTAR	Proper
frequency	Common
SLFMR	Proper
maps	Common
agreement	Common
psu	Common
sensitivity	Common
temperature	Common
K/psu	Common
observing	Common
angles	Common
temperatures	Common
SST	Common
polarization	Common
retrieval	Common
model	Common
corrections	Common
sensor	Common
increasing	Common
emissivity	Common
roughness	Common
foam	Common
decades	Common
correction	Common
tower	Common
wind	Common
WISE	Proper
Sensor	Proper
PALS	Proper
campaign	Common
Radio	Proper
instruments	Common
Ocean	Proper
Land	Proper
Studies	Proper
CAROLS	Proper
campaigns	Common
emission	Common
models	Common
slope	Common
approximation	Common
perturbation	Common
SSA	Proper
SPM	Proper
TSM	Proper
threshold	Common
m	Common
s	Common
wave	Common
breaking	Common
transfer	Common
equation	Common
RTE	Proper
frequencies	Common
spectrum	Common
factor	Common
choice	Common
cutoff	Common
wavenumber	Common
contribution	Common
determination	Common
biases	Common
radio	Common
interference	Common
RFI	Common
China	Common
Bohai	Proper
East	Proper
area	Common
accuracies	Common
tail	Common
ontogeny	Common
chickens	Common
posture	Common
kinematics	Common
dinosaurs	Common
displacement	Common
CoM	Common
femur	Common
standing	Common
animals	Common
subjects	Common
retraction	Common
knee	Common
flexion	Common
walking	Common
shift	Common
bird	Common
locomotion	Common
hip	Common
crocodilians	Common
archosaur	Common
mammals	Common
Carrano	Proper
Biewener	Proper
limb	Common
mass	Common
proxy	Common
postures	Common
caution	Common
relationships	Common
Differences	Common
orientation	Common
loading	Common
regimes	Common
bones	Common
element	Common
reaction	Common
GRF	Common
bending	Common
forces	Common
bone	Common
lengths	Common
patterns	Common
scaling	Common
theropods	Common
birds	Common
Birds	Common
femora	Common
manipulations	Common
loads	Common
horizontal	Common
idea	Common
morphology	Common
correlates	Common
limbs	Common
moments	Common
verticalization	Common
rearing	Common
exercising	Common
tails	Common
enclosure	Common
cages	Common
minutes	Common
days	Common
week	Common
evolution	Common
reorganization	Common
musculature	Common
setup	Common
theropod	Common
moment	Common
inertia	Common
position	Common
relatedness	Common
dinosaur	Common
hindlimb	Common
inferences	Common
convergence	Common
caveat	Common
reduction	Common
forelimb	Common
enlargement	Common
avenues	Common
investigation	Common
facets	Common
mechanics	Common
energetics	Common
Wedding	Proper
Discourse	Common
Analysis	Proper
Fan	Proper
Responses	Common
Game	Common
Thrones	Proper
exaggeration	Common
HBO	Proper
television	Common
brand	Common
transmedia	Common
Marsha	Proper
Kinder	Proper
Henry	Proper
Jenkins	Proper
networks	Common
intertextualities	Common
storyworld	Common
seasons	Common
episodes	Common
viewership	Common
season	Common
viewers	Common
episode	Common
Shepherd	Proper
video	Common
novel	Common
adaptation	Common
companion	Common
books	Common
rap	Common
albums	Common
city	Common
tour	Common
variety	Common
tabletop	Common
toys	Common
merchandise	Common
apps	Common
podcasts	Common
fanfics	Common
fan	Common
creations	Common
volume	Common
fandom	Common
fans	Common
network	Common
paratexts	Common
intertexts	Common
narratives	Common
Transmedia	Common
Star	Proper
Wars	Proper
Harry	Proper
Potter	Proper
Dead	Proper
Marvel	Proper
Universe	Proper
microcosm	Common
challenge	Common
fire	Common
hose	Common
flow	Common
practitioners	Common
industry	Common
consumer	Common
humanists	Common
transformations	Common
Methodology	Proper
discourse	Common
plot	Common
developments	Common
material	Common
screen	Common
Rains	Proper
Castamere	Proper
Benioff	Proper
Weiss	Proper
Readers	Common
events	Common
show	Common
narrative	Common
inception	Common
writers	Common
AV	Proper
Club	Proper
Experts	Common
spoilers	Common
Newbies	Common
comment	Common
threads	Common
thread	Common
outcome	Common
comments	Common
coding	Common
Charmaz	Proper
categorization	Common
tactics	Common
categories	Common
negotiation	Common
sub-categories	Common
examination	Common
perspective	Common
De	Proper
Certeau	Proper
life	Common
consumers	Common
behaviors	Common
Bernoulli	Proper
FRS	Proper
pronunciation	Common
bɛʁˈnʊli	Proper
February	Proper
mathematician	Common
physicist	Common
mathematicians	Common
family	Common
mathematics	Common
fluid	Common
probability	Common
name	Common
principle	Common
carburetor	Common
airplane	Common
wing	Common
Frontpage	Common
Hydrodynamica	Proper
Groningen	Proper
Netherlands	Proper
Antwerp	Proper
persecution	Common
Huguenots	Proper
Frankfurt	Proper
Basel	Proper
Switzerland	Proper
son	Common
Johann	Proper
developers	Common
calculus	Common
nephew	Common
brothers	Common
Niklaus	Proper
W.	Proper
Rouse	Proper
Ball	Proper
Bernoullis	Proper
father	Common
contest	Common
Paris	Proper
shame	Common
equal	Common
house	Common
ideas	Common
Hydraulica	Proper
reconciliation	Common
grudge	Common
death	Common
rewards	Common
wish	Common
medicine	Common
condition	Common
Heidelberg	Proper
Strasbourg	Proper
anatomy	Common
botany	Common
friend	Common
Leonhard	Proper
Euler	Proper
St.	Proper
Petersburg	Proper
professor	Common
illness	Common
excuse	Common
chairs	Common
metaphysics	Common
philosophy	Common
May	Proper
Fellow	Proper
Society	Proper
Exercitationes	Proper
Exercises	Proper
Goldbach	Proper
desirability	Common
motion	Common
motions	Common
translation	Common
rotation	Common
Joseph	Proper
Louis	Proper
Lagrange	Proper
Mécanique	Proper
Analytique	Proper
memoir	Common
tides	Common
memoirs	Common
Colin	Proper
Maclaurin	Proper
prize	Common
Isaac	Proper
Newton	Proper
Philosophiae	Proper
Naturalis	Proper
Principia	Proper
Mathematica	Proper
investigations	Common
Pierre	Proper
Simon	Proper
Laplace	Proper
papers	Common
strings	Common
Brook	Proper
Taylor	Proper
Jean	Proper
le	Proper
Rond	Proper
d'Alembert	Proper
fluids	Common
blood	Common
pressure	Common
wall	Common
pipe	Common
straw	Common
height	Common
physicians	Common
Europe	Proper
patients	Common
glass	Common
tubes	Common
arteries	Common
doctor	Common
aircraft	Common
plane	Common
Conservation	Proper
law	Common
ρ	Common
u	Common
P	Common
constant	Common
density	Common
velocity	Common
consequence	Common
aeroplane	Common
Tianjin	Proper
ancestry	Common
Changzhou	Proper
Jiangsu	Proper
province	Common
Chao	Proper
Boxer	Proper
Indemnity	Proper
Scholarship	Proper
physics	Common
Cornell	Proper
classmate	Common
Hu	Proper
Shih	Proper
leader	Common
Culture	Common
Movement	Proper
Ph.D.	Proper
Harvard	Proper
dissertation	Common
Continuity	Proper
Study	Proper
interests	Common
music	Common
Greek	Proper
Latin	Proper
Bertrand	Proper
Russell	Proper
interpreter	Common
Autobiography	Proper
dialect	Common
effort	Common
gift	Common
acuity	Common
Career	Common
physician	Common
Yang	Proper
Buwei	Proper
year	Common
ceremony	Common
wedding	Common
account	Common
newspapers	Common
couple	Common
marriage	Common
Tsinghua	Proper
Wu	Proper
fieldwork	Common
Institute	Proper
History	Proper
Philology	Proper
Academia	Proper
Sinica	Proper
Luo	Proper
Changpei	Proper
Fang	Proper
Kuei	Proper
linguists	Common
Bernhard	Proper
Karlgren	Proper
Etudes	Proper
sur	Proper
la	Proper
Phonologie	Proper
Chinoise	Proper
US	Proper
president	Common
citizen	Common
1950s	Common
members	Common
California	Proper
Berkeley	Proper
Agassiz	Proper
Professor	Proper
senses	Common
humor	Common
love	Common
jokes	Common
puns	Common
Life	Common
Chaos	Proper
autobiography	Common
Deng	Proper
Xiaoping	Proper
invitation	Common
Premier	Proper
Zhou	Proper
En	Proper
Lai	Proper
wife	Common
1940s	Common
June	Proper
Cambridge	Proper
Massachusetts	Proper
daughter	Common
Rulan	Proper
Pian	Proper
Music	Proper
Lensey	Proper
Charles	Proper
L'Enfant	Proper
pjɛʁ	Proper
ʃɑʁl	Proper
lɑ̃fɑ̃	Proper
Peter	Proper
engineer	Common
plan	Common
Washington	Proper
D.C.	Proper
capital	Common
U.S.	Proper
Plan	Common
painter	Common
reputation	Common
service	Common
King	Proper
Marie	Proper
official	Common
court	Common
brother	Common
Louvre	Proper
Painting	Proper
Sculpture	Proper
War	Proper
side	Common
colonials	Common
Augustin	Proper
Caron	Proper
Beaumarchais	Proper
Army	Proper
General	Proper
Lafayette	Proper
captain	Common
Corps	Proper
Engineers	Proper
April	Proper
origins	Common
colonies	Common
George	Proper
Valley	Proper
Forge	Proper
Marquis	Proper
portrait	Common
Siege	Proper
Savannah	Proper
October	Proper
prisoner	Common
war	Common
surrender	Common
Charleston	Proper
South	Proper
Carolina	Proper
November	Proper
remainder	Common
Revolution	Proper
brevet	Common
Major	Proper
cause	Common
liberty	Common
December	Proper
badge	Common
Cincinnati	Proper
officers	Common
eagle	Common
request	Common
insignias	Common
veterans	Common
Post–Revolutionary	Proper
engineering	Common
firm	Common
York	Proper
fame	Common
architect	Common
Hall	Proper
furniture	Common
houses	Common
coins	Common
medals	Common
insignia	Common
Alexander	Proper
Hamilton	Proper
correspondances	Common
Archives	Proper
Freemasonry	Proper
Holland	Proper
Lodge	Proper
No.	Proper
F&AM	Proper
degrees	Common
J.	Proper
Fillmore	Proper
linguist	Common
Linguistics	Common
Michigan	Proper
Ohio	Proper
Center	Proper
Sciences	Proper
Stanford	Proper
syntax	Common
semantics	Common
conference	Common
UC	Proper
celebration	Common
birthday	Common
Lifetime	Proper
Achievement	Proper
Award	Proper
Computational	Proper
Japan	Proper
discharge	Common
girls	Common
Kyoto	Proper
doctorate	Common
Columbus	Proper
proponent	Common
Noam	Proper
Chomsky	Proper
phase	Common
Grammar	Common
theories	Common
linguistics	Common
agent	Common
patient	Common
locations	Common
roles	Common
relations	Common
theta	Common
move	Common
Frame	Common
Semantics	Proper
event	Common
seller	Common
buyer	Common
good	Common
minds	Common
addressee	Common
Cruz	Proper
Lectures	Proper
Deixis	Proper
pragmatics	Common
utterance	Common
phenomena	Common
Paul	Proper
Kay	Proper
Lakoff	Proper
Construction	Common
constraint	Common
formalisms	Common
notion	Common
construction	Common
grammars	Common
Cathy	Proper
O'Connor	Proper
Regularity	Proper
Idiomaticity	Proper
Constructions	Proper
merits	Common
variants	Common
founders	Common
chapter	Common
Cruse	Proper
Croft	Proper
President	Proper
Chicago	Proper
legacy	Common
Adele	Proper
Goldberg	Proper
Laura	Proper
Michaelis	Proper
Christopher	Proper
Johnson	Proper
Miriam	Proper
R.	Proper
L.	Proper
Petruck	Proper
Len	Proper
Talmy	Proper
Eve	Proper
Sweetser	Proper
FrameNet	Proper
1990s	Common
lexicography	Common
Pisa	Proper
Sue	Proper
Atkins	Proper
discussions	Common
collaborations	Common
dictionary	Common
future	Common
sentences	Common
corpora	Common
Computer	Proper
lexicon	Common
Data	Common
Corpus	Proper
Frames	Common
Siméon	Proper
Poisson	Proper
Galois	Proper
expulsion	Common
École	Proper
Normale	Proper
class	Common
algebra	Common
activism	Common
priority	Common
equations	Common
July	Proper
argument	Common
rigor	Common
rejection	Common
report	Common
note	Common
opinion	Common
arrest	Common
prison	Common
character	Common
letter	Common
Auguste	Proper
Chevalier	Proper
advice	Common
manuscripts	Common
release	Common
duel	Common
motives	Common
speculation	Common
affair	Common
letters	Common
woman	Common
Stéphanie	Proper
Félicie	Proper
Poterin	Proper
du	Proper
Motel	Proper
hostel	Common
months	Common
Fragments	Common
portions	Common
troubles	Common
behalf	Common
conjecture	Common
friends	Common
cousin	Common
Gabriel	Proper
Demante	Proper
uncle	Common
fiancé	Common
victim	Common
coquette	Common
dupes	Common
biographers	Common
Eric	Proper
Temple	Proper
Bell	Proper
Men	Common
Mathematics	Proper
incident	Common
police	Common
factions	Common
enemy	Common
opponent	Common
Alexandre	Proper
Dumas	Proper
Pescheux	Proper
d'Herbinville	Proper
artillery	Common
acquittal	Common
banquet	Common
assertion	Common
newspaper	Common
clippings	Common
initials	Common
D.	Proper
Ernest	Proper
Duchatelet	Proper
charges	Common
identity	Common
killer	Common
testament	Common
Mathematician	Common
Hermann	Proper
Weyl	Proper
novelty	Common
profundity	Common
piece	Common
writing	Common
mankind	Common
legend	Common
edges	Common
manuscript	Common
memorial	Common
cemetery	Common
Bourg	Proper
Reine	Proper
Évariste	Proper
grave	Common
morning	Common
abdomen	Common
opponents	Common
seconds	Common
farmer	Common
Hôpital	Proper
Cochin	Proper
peritonitis	Common
offices	Common
priest	Common
funeral	Common
riots	Common
plans	Common
uprising	Common
leaders	Common
Maximilien	Proper
Lamarque	Proper
rising	Common
Alfred	Proper
courage	Common
Montparnasse	Proper
Cemetery	Proper
town	Common
cenotaph	Common
honour	Common
graves	Common
relatives	Common
Matthew	Proper
Goode	Proper
William	Proper
actor	Common
debut	Common
ABC	Proper
TV	Common
film	Common
Confessions	Proper
Stepsister	Proper
breakthrough	Common
comedy	Common
Chasing	Proper
Liberty	Proper
nomination	Common
Teen	Proper
Choice	Proper
Awards	Proper
Breakout	Proper
Movie	Proper
string	Common
films	Common
Woody	Proper
Allen	Proper
Match	Proper
Point	Proper
Imagine	Proper
drama	Common
Copying	Proper
Beethoven	Proper
praise	Common
Ryder	Proper
Julian	Proper
Jarrold	Proper
Evelyn	Proper
Waugh	Proper
Brideshead	Proper
Revisited	Proper
Ozymandias	Proper
superhero	Common
Watchmen	Proper
DC	Proper
Comics	Proper
Leap	Proper
Year	Proper
Man	Proper
Actor	Common
Film	Proper
Critics	Common
Circle	Proper
Australia	Proper
Lookout	Common
Junction	Proper
Stoker	Proper
Belle	Proper
Imitation	Proper
Self/less	Proper
shows	Common
Talbot	Proper
Downton	Proper
Abbey	Proper
Finley	Proper
Finn	Proper
Polmar	Proper
CBS	Proper
Wife	Proper
mini-serial	Common
Dancing	Proper
Edge	Proper
journalist	Common
Stanley	Proper
Mitchell	Proper
Miniseries	Common
Television	Proper
Satellite	Common
Antony	Proper
Armstrong	Proper
Jones	Proper
Earl	Proper
Snowdon	Proper
Netflix	Proper
Crown	Proper
Primetime	Proper
Emmy	Proper
Guest	Proper
Drama	Proper
Series	Proper
Sky	Proper
One	Proper
fantasy	Common
romance	Common
Discovery	Proper
Witches	Proper
Clairmont	Proper
Vaughn	Proper
Kingsman	Proper
prequel	Common
Sophie	Proper
Dymoke	Proper
daughters	Common
Matilda	Proper
Teddie	Proper
Eleanor	Proper
Rose	Proper
Ralph	Proper
Lynley	Proper
Inspector	Proper
BBC	Proper
Mysteries	Proper
Vengeance	Proper
Gregory	Proper
Maguire	Proper
Shakespeare	Proper
play	Common
Tempest	Proper
Mandy	Proper
Moore	Proper
Exeter	Proper
Devon	Proper
Anthony	Proper
geologist	Common
mother	Common
Jennifer	Proper
nurse	Common
amateur	Common
theatre	Common
director	Common
presenter	Common
Sally	Proper
Meen	Proper
village	Common
Clyst	Proper
Mary	Proper
Birmingham	Proper
London	Proper
Webber	Proper
Douglas	Proper
bust	Common
Patrick	Proper
Gordon	Proper
Yekaterinburg	Proper
Russia	Proper
Leopold	Proper
Auchleuchries	Proper
Aberdeenshire	Proper
Scotland	Proper
Moscow	Proper
general	Common
admiral	Common
origin	Common
holders	Common
estate	Common
Ellon	Proper
branch	Common
Haddo	Proper
Sweden	Proper
Poland	Proper
ranks	Common
trooper	Common
advisor	Common
Tsar	Proper
Catholic	Proper
Church	Proper
parish	Common
Cruden	Proper
Braunsberg	Proper
Prussia	Proper
mind	Common
journey	Common
foot	Common
parts	Common
Germany	Proper
Hamburg	Proper
Battle	Proper
Chudnov	Proper
restoration	Common
England	Proper
experiences	Common
soldier	Common
fortune	Common
army	Common
Aleksei	Proper
I	Proper
mission	Common
wars	Common
Turks	Proper
Tatars	Proper
corruption	Common
venality	Common
officials	Common
wit	Common
vexation	Common
major	Common
command	Common
Kiev	Proper
lieutenant	Common
Scots	Proper
Menzies	Proper
Livingston	Proper
intolerance	Common
adventure	Common
expeditions	Common
Crimea	Proper
revolution	Common
troops	Common
favour	Common
Regent	Proper
Tsarevna	Proper
Sophia	Proper
Alekseyevna	Proper
absence	Common
rampart	Common
Russians	Proper
Azov	Proper
tomb	Common
Vvedenskoye	Proper
achievements	Common
permission	Common
Tsars	Proper
church	Common
Muscovy	Proper
benefactor	Common
James	Proper
brigadier	Common
Count	Proper
Empire	Proper
West	Proper
rank	Common
hands	Common
eyes	Common
Quarter	Common
remains	Common
inscription	Common
Oberst	Proper
Colonel	Proper
diary	Common
Russian	Proper
Military	Proper
Archive	Proper
Dr	Proper
Moritz	Proper
Posselt	Proper
St	Proper
Passages	Proper
Diary	Proper
editorship	Common
Spalding	Proper
Aberdeen	Proper
edition	Common
Centre	Proper
Scottish	Proper
vols	Common
Rudolf	Proper
Strasburgh	Proper
kinsman	Common
Auchintoul	Proper
Emperor	Proper
Zaha	Proper
Hadid	Proper
Dame	Proper
Mohammad	Proper
DBE	Proper
RA	Proper
Arabic	Proper
Zahā	Proper
Ḥadīd	Proper
Pritzker	Proper
Architecture	Common
award	Common
Stirling	Proper
Elizabeth	Proper
architecture	Common
Gold	Proper
Medal	Proper
Architects	Proper
Guardian	Proper
Queen	Proper
curve	Common
centre	Common
Olympics	Proper
Broad	Proper
Museum	Proper
Guangzhou	Proper
Opera	Proper
House	Proper
designs	Common
statuette	Common
Brit	Proper
buildings	Common
Al	Proper
Wakrah	Proper
Stadium	Proper
Qatar	Proper
venue	Common
FIFA	Proper
Cup	Proper
career	Common
Baghdad	Proper
Iraq	Proper
Mohammed	Proper
Muhammad	Proper
al	Proper
Hajj	Proper
Husayn	Proper
industrialist	Common
Mosul	Proper
Ahali	Proper
organisation	Common
1930s	Common
co-founder	Common
Party	Proper
minister	Common
finance	Common
overthrow	Common
monarch	Common
Abd	Proper
Karim	Proper
Qasim	Proper
Wajiha	Proper
Sabunji	Proper
artist	Common
1960s	Common
boarding	Common
American	Proper
Beirut	Proper
Architectural	Proper
Rem	Proper
Koolhaas	Proper
Elia	Proper
Zenghelis	Proper
Bernard	Proper
Tschumi	Proper
graduation	Common
planet	Common
orbit	Common
pupil	Common
inventor	Common
vision	Common
pieces	Common
staircases	Common
staircase	Common
head	Common
ceiling	Common
corner	Common
joinery	Common
painting	Common
hotel	Common
bridge	Common
suprematist	Common
Kazimir	Proper
Malevich	Proper
Ichiyō	Proper
Higuchi	Proper
pen	Common
Natsu	Proper
Natsuko	Proper
stories	Common
Meiji	Proper
writer	Common
Efforts	Common
ends	Common
needlework	Common
washing	Common
jobs	Common
success	Common
Kaho	Proper
Tanabe	Proper
novelist	Common
fiction	Common
story	Common
poet	Common
editors	Common
Tosui	Proper
Nakarai	Proper
womanizer	Common
mentor	Common
theme	Common
break	Common
Ichiyo	Proper
Heian	Proper
plots	Common
sentiment	Common
trademark	Common
man	Common
background	Common
ragamuffin	Common
ambition	Common
cruelty	Common
Umoregi	Proper
Obscurity	Proper
earnest	Common
neighborhood	Common
stationery	Common
store	Common
dwelling	Common
minute	Common
walk	Common
Tokyo	Proper
district	Common
Yoshiwara	Proper
Takekurabe	Proper
Comparing	Proper
heights	Proper
Child	Common
Play	Proper
Robert	Proper
Lyons	Proper
Danly	Proper
Growing	Proper
Edward	Proper
Seidensticker	Proper
concern	Common
plight	Common
women	Common
Ihara	Proper
Saikaku	Proper
distinctiveness	Common
acceptance	Common
characters	Common
awareness	Common
suffering	Common
Ōtsugomori	Proper
Day	Proper
Nigorie	Proper
Waters	Proper
Wakare	Proper
Michi	Proper
Ways	Proper
Jūsan'ya	Proper
Night	Proper
admirers	Common
critics	Common
interruptions	Common
headaches	Common
tuberculosis	Common
likeness	Common
banknote	Common
fall	Common
Empress	Proper
Jingū	Proper
Murasaki	Proper
Shikibu	Proper
movies	Common
Brock	Proper
Holt	Proper
Boston	Proper
Sox	Proper
baseman	Common
Shortstop	Common
Outfielder	Common
Fort	Proper
Worth	Proper
Texas	Proper
MLB	Proper
Pittsburgh	Proper
Pirates	Proper
Batting	Common
average	Common
Home	Proper
runs	Common
Runs	Common
Teams	Common
present	Common
highlights	Common
awards	Common
champion	Common
Wyatt	Proper
baseball	Common
shortstop	Common
outfielder	Common
League	Proper
Baseball	Proper
infielder	Common
pitcher	Common
catcher	Common
feet	Common
inches	Common
pounds	Common
kg	Common
Stephenville	Proper
freshman	Common
District	Proper
4A	Proper
All	Proper
team	Common
league	Common
Newcomer	Proper
inclusion	Common
sophomore	Common
honors	Common
Rice	Common
batting	Common
RBIs	Common
Owls	Proper
bases	Common
NCAA	Proper
Team	Proper
Glove	Proper
Trophy	Proper
club	Common
round	Common
Draft	Proper
pick	Common
teammate	Common
Ryan	Proper
Berry	Proper
leagues	Common
Class	Common
affiliate	Common
Spikes	Proper
Bradenton	Proper
Marauders	Proper
injury	Common
ligament	Common
Altoona	Proper
Curve	Proper
MVP	Common
run	Common
homer	Common
inning	Common
Indianapolis	Proper
Indians	Proper
minors	Common
rosters	Common
promotion	Common
Houston	Proper
Astros	Proper
hit	Common
majors	Common
Jack	Proper
Merson	Proper
RBI	Common
Joel	Proper
Hanrahan	Proper
Jerry	Proper
Sands	Proper
Stolmy	Proper
Pimentel	Proper
Mark	Proper
Melancon	Proper
Iván	Proper
DeJesús	Proper
Pawtucket	Proper
Anaheim	Proper
championship	Common
ring	Common
Cardinals	Proper
postseason	Common
Will	Proper
Middlebrooks	Proper
Tampa	Proper
Bay	Proper
Rays	Proper
Fenway	Proper
Park	Proper
Xander	Proper
Bogaerts	Proper
catch	Common
warning	Common
Ian	Proper
Kinsler	Proper
Nava	Proper
bottom	Common
doubles	Common
Jerome	Proper
dʒəˈroʊm	Proper
Eusebius	Proper
Sophronius	Proper
Hieronymus	Proper
Εὐσέβιος	Proper
Σωφρόνιος	Proper
Ἱερώνυμος	Proper
confessor	Common
theologian	Common
historian	Common
Saint	Proper
Stridon	Proper
Emona	Proper
border	Common
Dalmatia	Proper
Pannonia	Proper
Bible	Proper
Vulgate	Proper
Gospels	Proper
writings	Common
protégé	Common
Pope	Proper
Damasus	Proper
teachings	Common
centers	Common
Rome	Proper
lives	Common
Jesus	Proper
focus	Common
patron	Common
ascetics	Common
families	Common
saint	Common
Doctor	Proper
Orthodox	Proper
Communion	Proper
feast	Common
AD	Common
Bonosus	Proper
Sardica	Proper
hermit	Common
island	Common
Adriatic	Proper
grammarian	Common
Aelius	Proper
Donatus	Proper
familiarity	Common
schoolboy	Common
escapades	Common
experimentation	Common
bouts	Common
guilt	Common
conscience	Common
Sundays	Common
sepulchres	Common
martyrs	Common
Apostles	Common
catacombs	Common
terrors	Common
hell	Common
crypts	Common
earth	Common
walls	Common
Psalmist	Proper
Hell	Proper
windows	Common
shafts	Common
horror	Common
darkness	Common
Vergil	Proper
Domenico	Proper
Ghirlandaio	Proper
quote	Common
Virgil	Proper
sides	Common
silence	Common
terror	Common
soul	Common
practices	Common
pederasty	Common
citation	Common
Conversion	Common
Christianity	Proper
Nuremberg	Proper
Chronicle	Proper
Gaul	Proper
Trier	Proper
Tyrannius	Proper
Rufinus	Proper
Hilary	Proper
Poitiers	Proper
commentary	Common
Psalms	Proper
treatise	Common
synodis	Proper
stay	Common
Aquileia	Proper
Thrace	Proper
Asia	Proper
Minor	Proper
Syria	Proper
Antioch	Proper
companions	Common
illnesses	Common
winter	Common
God	Proper
classics	Common
impulse	Common
Apollinaris	Proper
Laodicea	Proper
heresy	Common
Desert	Proper
Giovanni	Proper
Bellini	Proper
desire	Common
penance	Common
desert	Common
Chalcis	Proper
southeast	Common
Syrian	Proper
Thebaid	Proper
eremites	Common
attempt	Common
Hebrew	Proper
guidance	Common
Jew	Common
correspondence	Common
Christians	Common
Gospel	Proper
fragments	Common
notes	Common
Hebrews	Proper
Nazarenes	Proper
Jenna	Proper
Marbles	Proper
Nicole	Proper
Mourey	Proper
pseudonym	Common
YouTube	Proper
personality	Common
vlogger	Common
comedian	Common
actress	Common
channel	Common
subscribers	Common
star	Common
wax	Common
Madame	Proper
Tussauds	Proper
New	Proper
Rochester	Proper
Brighton	Proper
High	Proper
chemist	Common
patents	Common
Suffolk	Proper
Bachelor	Common
Psychology	Proper
Master	Proper
Sport	Proper
Counseling	Proper
summer	Common
bedroom	Common
apartment	Common
rent	Common
tanning	Common
salon	Common
go	Common
nightclubs	Common
Barstool	Proper
Sports	Common
female	Common
StoolLaLa	Proper
Wednesday	Proper
Thursday	Proper
People	Common
Want	Proper
Times	Proper
News	Proper
guys	Common
dance	Common
genitalia	Common
backside	Common
surname	Common
videos	Common
Google	Proper
employers	Common
Mr.	Proper
Rap	Proper
Battles	Proper
Adam	Proper
banana	Common
Orange	Proper
Fake	Proper
Bacon	Proper
Miley	Proper
Cyrus	Proper
Wrecking	Proper
segment	Common
Rewind	Proper
Ridiculousness	Proper
Smosh	Proper
selfie	Common
affairs	Common
assistant	Common
manager	Common
officer	Common
podcast	Common
boyfriend	Common
Julien	Proper
Solomita	Proper
Podcast	Proper
Topics	Common
conspiracy	Common
YouTubers	Proper
guests	Common
Shane	Proper
Dawson	Proper
ventures	Common
Kermie	Proper
Worm	Proper
appearances	Common
dogs	Common
quotes	Common
pop	Common
countdown	Common
SiriusXM	Proper
Hits	Proper
producer	Common
Ride	Proper
novels	Common
Patterson	Proper
vegan	Common
YouTuber	Proper
Kermit	Proper
Peach	Proper
Bunny	Proper
Jeanne	Proper
Moreau	Proper
Resting	Common
Montmartre	Proper
Alma	Common
mater	Common
Conservatoire	Proper
Occupation	Common
Actress	Common
screenwriter	Common
Years	Common
Spouse(s)	Common
Richard	Proper
Friedkin	Proper
Children	Common
Jérôme	Proper
ʒan	Proper
mɔʁo	Proper
singer	Common
Cannes	Proper
Festival	Proper
Days	Proper
Nights	Proper
BAFTA	Proper
Viva	Proper
Maria	Proper
César	Proper
Lady	Proper
Sea	Proper
recipient	Common
lifetime	Common
Fellowship	Proper
Palm	Proper
actresses	Common
Comédie	Proper
Française	Proper
performances	Common
Fernandel	Proper
vehicle	Common
Meurtres	Proper
Sinners	Proper
Gabin	Proper
showgirl	Common
gangster	Common
moll	Common
Touchez	Proper
pas	Proper
au	Proper
grisbi	Proper
prominence	Common
Elevator	Common
Gallows	Proper
Malle	Proper
Jules	Proper
et	Proper
Jim	Proper
François	Proper
Truffaut	Proper
80s	Common
Katherine	Proper
Buckley	Proper
dancer	Common
Folies	Proper
Bergère	Proper
Anatole	Proper
Désiré	Proper
restaurateur	Common
native	Common
Oldham	Proper
Lancashire	Proper
descent	Common
Protestant	Common
Catholicism	Proper
girl	Common
Vichy	Proper
vacations	Common
Mazirat	Proper
valley	Common
Allier	Proper
tombstone	Common
Anouilh	Proper
Antigone	Proper
calling	Common
conservatory	Common
Michelle	Proper
Avignon	Proper
Ivan	Proper
Turgenev	Proper
Month	Proper
Country	Proper
20s	Common
troupe	Common
Théâtre	Proper
Populaire	Proper
Gérard	Proper
Philipe	Proper
Hirsch	Proper
Hour	Proper
Anna	Proper
Bonacci	Proper
Cocteau	Proper
La	Proper
Machine	Proper
Infernale	Proper
Shaw	Proper
Pygmalion	Proper
makers	Common
Lovers	Proper
Les	Proper
Amants	Proper
Wave	Proper
directors	Common
Michelangelo	Proper
Antonioni	Proper
notte	Proper
Clouds	Proper
Orson	Proper
Welles	Proper
Trial	Proper
Chimes	Proper
Midnight	Proper
Story	Proper
Luis	Proper
Buñuel	Proper
Chambermaid	Proper
Kazan	Proper
Tycoon	Common
Rainer	Proper
Werner	Proper
Fassbinder	Proper
Querelle	Proper
Wim	Proper
Wenders	Proper
End	Common
Carl	Proper
Foreman	Proper
Champion	Proper
Victors	Proper
Manoel	Proper
Oliveira	Proper
Gebo	Proper
l'	Proper
Ombre	Proper
jury	Common
Berlin	Proper
Stanislavsky	Proper
vocalist	Common
Frank	Proper
Sinatra	Proper
Carnegie	Proper
acting	Common
camera	Common
accomplishments	Common
Calling	Proper
Shots	Proper
Janis	Proper
Cole	Proper
Holly	Proper
Dale	Proper
Eugene	Proper
Nida	Proper
A.	Proper
equivalence	Common
Translation	Proper
Oklahoma	Proper
Christian	Proper
altar	Common
call	Common
Christ	Proper
Saviour	Common
Camp	Proper
Wycliffe	Proper
Chihuahua	Proper
Mexico	Proper
diet	Common
altitude	Common
charter	Common
member	Common
Translators	Proper
Summer	Proper
master	Common
Testament	Proper
pastor	Common
Calvary	Proper
Ana	Proper
resignation	Common
Evangelical	Proper
Baptist	Proper
Althea	Proper
Lucille	Proper
Sprague	Proper
María	Proper
Elena	Proper
Fernandez	Proper
Miranda	Proper
lawyer	Common
1980s	Common
lectures	Common
Alpine	Proper
Arizona	Proper
USA	Proper
Madrid	Proper
Brussels	Proper
Belgium	Proper
Theories	Common
pioneer	Common
Synopsis	Proper
Syntax	Proper
constituent	Common
textbook	Common
Morphology	Proper
Words	Proper
Structuralism	Proper
introduction	Common
exercises	Common
Equivalence	Proper
components	Common
bachelor	Common
male	Common
opposition	Common
philologists	Common
text	Common
ST	Proper
inter-animation	Common
page	Common
essay	Common
Principles	Proper
Correspondence	Proper
meanings	Common
symbols	Common
phrases	Common
translations	Common
original	Common
detail	Common
message	Common
messages	Common
consideration	Common
translator	Common
intelligibility	Common
misunderstanding	Common
decoding	Common
things	Common
equivalents	Common
equivalent	Common
orientations	Common
F	Proper
correspondences	Common
sentence	Common
gloss	Common
reproduction	Common
consistency	Common
Jared	Proper
Padalecki	Proper
Tristan	Proper
Sam	Proper
Winchester	Proper
Supernatural	Proper
2000s	Common
Gilmore	Proper
Girls	Common
Minute	Proper
Wax	Proper
San	Proper
Antonio	Proper
Gerald	Proper
Sherri	Proper
candidate	Common
Scholars	Proper
Program	Proper
partner	Common
Chris	Proper
Cardenas	Proper
Forensic	Proper
Duo	Proper
Interpretation	Proper
Los	Proper
Angeles	Proper
Fox	Proper
Broadcasting	Proper
Claim	Proper
Fame	Proper
Contest	Proper
Little	Proper
Inside	Proper
Dean	Proper
Forester	Proper
Witness	Proper
Close	Proper
Disney	Proper
Channel	Proper
Ring	Proper
bully	Common
Cheaper	Proper
Dozen	Proper
Tom	Proper
Welling	Proper
Charlie	Proper
movie	Common
MacGyver	Proper
Kate	Proper
Ashley	Proper
Olsen	Proper
Trey	Proper
Lipton	Proper
boy	Common
Olsens	Proper
thriller	Common
Flight	Common
Phoenix	Proper
Dennis	Proper
Quaid	Proper
Hugh	Proper
Laurie	Proper
Elisha	Proper
Cuthbert	Proper
Chad	Proper
Michael	Proper
Murray	Proper
Hilton	Proper
Wade	Proper
Cry	Proper
Wolf	Proper
WB	Proper
Jensen	Proper
Ackles	Proper
predators	Common
demons	Common
angels	Common
manner	Common
sci	Common
fi	Common
genre	Common
CW	Proper
title	Common
host	Common
MTV	Proper
reality	Common
ratings	Common
Christmas	Proper
Cottage	Proper
Thomas	Proper
Kinkade	Proper
O'Toole	Proper
version	Common
Friday	Proper
Clay	Proper
Crystal	Proper
Lake	Proper
search	Common
engagement	Common
co-star	Common
Genevieve	Proper
Cortese	Proper
guest	Common
Ruby	Proper
front	Common
Joan	Proper
Arc	Proper
realist	Common
Bastien	Proper
Lepage	Proper
pair	Common
hometown	Common
Sun	Proper
Idaho	Proper
Colton	Proper
birth	Common
Austin	Proper
Shep	Proper
Odette	Proper
Elliott	Proper
co-stars	Common
Misha	Proper
Collins	Proper
Beto	Proper
O'Rourke	Proper
Senate	Proper
election	Common
Represent.com	Proper
funds	Common
Love	Common
Arms	Proper
depression	Common
addiction	Common
suicide	Common
struggles	Common
shirt	Common
faces	Common
fund	Common
shirts	Common
Diego	Proper
Comic	Proper
Con	Proper
panel	Common
candles	Common
battle	Common
Theodorus	Proper
Tabennese	Proper
Abba	Proper
Theodore	Proper
Sanctified	Proper
successor	Common
Pachomius	Proper
federation	Common
founder	Common
Icon	Common
Biography	Common
hagiography	Common
excesses	Common
fourteen	Common
monastery	Common
diocese	Common
Sne	Proper
Esna	Proper
Egypt	Proper
virtues	Common
Koinonia	Proper
destiny	Common
passage	Common
monk	Common
obedience	Common
favorite	Common
comforter	Common
reprimands	Common
youth	Common
steward	Common
monasteries	Common
Phbow	Proper
monks	Common
watch	Common
reprimand	Common
governing	Common
popularity	Common
demotion	Common
verge	Common
glory	Common
weeping	Common
prayer	Common
solitude	Common
Normalcy	Common
Petronios	Proper
Apa	Proper
Horsiesios	Proper
charge	Common
Phnoum	Proper
submission	Common
rebels	Common
headquarters	Common
predecessors	Common
spite	Common
shifting	Common
prediction	Common
pouch	Common
rate	Common
Nierman	Proper
guy	Common
national	Common
dollars	Common
lot	Common
Albert	Proper
Marcia	Proper
relative	Common
cab	Common
driver	Common
rides	Common
ride	Common
miles	Common
car	Common
card	Common
door	Common
Buddy	Proper
ruins	Common
stuff	Common
commission	Common
studio	Common
Rae	Proper
recorder	Common
deal	Common
dollar	Common
swap	Common
fit	Common
colony	Common
Americans	Proper
cost	Common
living	Common
watermelon	Common
Geri	Proper
styles	Common
office	Common
Ben	Proper
Money	Common
bucks	Common
color	Common
Lot	Common
junk	Common
fellow	Common
LeRoy	Proper
Neiman	Proper
parks	Common
weather	Common
Sunday	Proper
artists	Common
Village	Proper
Parks	Proper
thousands	Common
lots	Common
jewelry	Common
shops	Common
galleries	Common
G.	Proper
Robinson	Proper
Hollywood	Proper
handlebar	Common
mustache	Common
Leonardo	Proper
Joe	Proper
Namath	Proper
seriograph	Common
Acapulco	Proper
football	Common
players	Common
horse	Common
races	Common
folks	Common
table	Common
ice	Common
pan	Common
steam	Common
pot	Common
Fahrenheit	Proper
rock	Common
choir	Common
road	Common
itinerary	Common
sholids	Common
solid	Common
shape	Common
bath	Common
soda	Common
milk	Common
Liquid	Common
liquid	Common
container	Common
cloud	Common
Gas	Common
gas	Common
heat	Common
balloons	Common
Citizen	Proper
Kane	Proper
Rosebud	Proper
sled	Common
balloon	Common
counting	Common
suspense	Common
trinity	Common
Sesame	Proper
Street	Proper
complexities	Common
nation	Common
breakfast	Common
hole	Common
counter	Common
molecules	Common
equipment	Common
hooves	Common
Mae	Proper
Lynne	Proper
horses	Common
Dad	Common
thing	Common
lecture	Common
lab	Common
skeleton	Common
ligaments	Common
tendons	Common
shoulder	Common
hoof	Common
knife	Common
guide	Common
bit	Common
pebbles	Common
clods	Common
dirt	Common
burners	Common
iron	Common
blacksmithing	Common
coals	Common
horseshoe	Common
shoes	Common
matter	Common
farriers	Common
Farrier	Common
trimmer	Common
shoer	Common
horseshoes	Common
aught	Common
ones	Common
Clydesdales	Proper
Shires	Proper
ponies	Common
Judy	Proper
gifts	Common
Mom	Common
Campbell	Proper
presents	Common
mysteries	Common
elves	Common
Dan	Proper
babe	Common
keys	Common
bread	Common
baking	Common
Mrs.	Proper
steel	Common
sweatshirts	Common
yellow	Common
Thanks	Common
thanks	Common
sweater	Common
hon	Common
tights	Common
rum	Common
fruitcake	Common
kid	Common
back	Common
room	Common
picture	Common
tie	Common
photo	Common
Diana	Proper
Erasmus	Proper
egg	Common
Luther	Proper
freedom	Common
will	Common
Brendler	Proper
evening	Common
setting	Common
pamphlet	Common
Diatribe	Proper
assault	Common
theology	Common
Papacy	Proper
purgatory	Common
indulgences	Common
nonsense	Common
razor	Common
throat	Common
style	Common
dunderheads	Common
doctrine	Common
sin	Common
Pico	Proper
Mirandela	Proper
Houseman	Proper
Invictus	Proper
fate	Common
grace	Common
deeds	Common
pronouncements	Common
dignity	Common
man-	Common
semi-pelagianism	Common
salvation	Common
person	Common
arguments	Common
prerogative	Common
judgment	Common
mercy	Common
damnation	Common
center	Common
predestination	Common
dogma	Common
Geneva	Proper
reformer	Common
Calvin	Proper
teaching	Common
preconditions	Common
circumstances	Common
paragraph	Common
contrary	Common
whore	Common
Devil	Proper
situations	Common
rider	Common
Scriptures	Proper
passages	Common
disciples	Common
sayings	Common
Scripture	Proper
paradox	Common
kids	Common
Kathy	Proper
Bill	Proper
Wilson	Proper
yesterday	Common
carpenter	Common
floor	Common
barn	Common
hay	Common
lunch	Common
Doris	Proper
dinner	Common
lemon	Common
tea	Common
Schwa	Proper
Beth	Proper
Sherry	Proper
Lemon	Common
honey	Common
Jonathan	Proper
cold	Common
Carolyn	Proper
Martha	Proper
Barbara	Proper
potty	Common
Barb	Proper
boys	Common
Spock	Proper
Captain	Proper
Kirk	Proper
idiot	Common
Mister	Proper
hospital	Common
bronchitis	Common
news	Common
sort	Common
Way	Proper
emergency	Common
fever	Common
brain	Common
damage	Common
pediatrician	Common
fevers	Common
feathers	Common
babies	Common
immune	Common
germs	Common
Kevin	Proper
Jito	Proper
babinos	Common
Issac	Proper
nephews	Common
Jose	Proper
Gino	Proper
middle	Common
gestalt	Common
psychotherapist	Common
fault	Common
drink	Common
righ-	Common
righty	Common
bottle	Common
While	Common
grandpa	Common
Bottle	Common
witch	Common
Baby	Common
slobber	Common
mouth	Common
nose	Common
tube	Common
mist	Common
poster	Common
scientist	Common
crusade	Common
needs	Common
cartoon	Common
Scientist	Proper
stone	Common
statue	Common
arms	Common
rubble	Common
knees	Common
symbol	Common
crumbs	Common
myth	Common
insanity	Common
stars	Common
microscope	Common
directions	Common
communication	Common
branches	Common
connections	Common
edge	Common
bunch	Common
guider	Common
tool	Common
Einstein	Proper
thought	Common
peace	Common
consumerism	Common
phantom	Common
stair	Common
steppers	Common
burp	Common
Shadow	Proper
remake	Common
Chevy	Proper
Chase	Proper
Steven	Proper
Coke	Proper
cans	Common
bag	Common
can	Common
squish	Common
recycling	Common
bin	Proper
Tomorrow	Common
mom	Common
sinus	Common
infection	Common
Mmkay	Proper
Hamburger	Proper
Steve	Proper
iguana	Common
Robbie	Proper
Harley	Proper
Davidson	Proper
scarf	Common
tomorrow	Common
Toys	Proper
Us	Proper
catalog	Common
look	Common
chicken	Common
pizza	Common
coupons	Common
Nickelodean	Proper
box	Common
bowl	Common
goodies	Common
Yack	Proper
Pack	Common
tape	Common
dad	Common
Talkboys	Proper
Batman	Proper
Forever	Proper
Clause	Proper
Tim	Proper
Casper	Proper
Ghost	Proper
Zach	Proper
oja	Proper
Oija	Proper
Ouija	Proper
Ouiji	Proper
boards	Common
Course	Common
homework	Common
brains	Common
tooth	Common
teeth	Common
mess	Common
recheck	Common
x	Common
rays	Common
tonight	Common
antibiotics	Common
anesthesia	Common
distemper	Common
vaccine	Common
Trent	Proper
bandage	Common
hold	Common
Amoxi	Proper
Pred	Proper
afternoon	Common
Calculator	Common
pins	Common
cast	Common
fracture	Common
stifle	Common
legs	Common
Carol	Proper
tibia	Common
hock	Common
estimate	Common
coming	Common
bill	Common
anasthesia	Common
casting	Common
total	Common
extra	Common
X	Common
pin	Common
alternative	Common
Lindsey	Proper
kitty	Common
castration	Common
bye	Common
root	Common
thirds	Common
i	Proper
Nathan	Proper
Leah	Proper
Karate	Proper
Kid	Proper
bed	Common
arm	Common
Fraction	Common
denominator	Common
fraction	Common
square	Common
top	Common
twos	Common
z	Common
roots	Common
telling	Common
fifths	Common
Roberts	Proper
Builders	Common
Interiors	Proper
party	Common
carpet	Common
job	Common
contractor	Common
UCSB	Proper
employees	Common
burden	Common
payment	Common
procedure	Common
helpers	Common
check	Common
wage	Common
cents	Common
deduction	Common
employer	Common
window	Common
witness	Common
attorney	Common
Stu	Proper
sir	Common
Nick	Proper
dispute	Common
checks	Common
honor	Common
Anacapa	Proper
yard	Common
crews	Common
payroll	Common
contractors	Common
independents	Common
statements	Common
remodel	Common
remodels	Common
wages	Common
levels	Common
agility	Common
men	Common
deductions	Common
subcontractor	Common
security	Common
breakdown	Common
unemployment	Common
insurance	Common
Worker	Common
compensation	Common
Dr.	Proper
Guruswamy	Proper
Lords	Proper
Lord	Proper
Justice	Proper
Marriage	Proper
Act	Proper
Constitution	Proper
reform	Common
Code	Proper
divorce	Common
inheritance	Common
wisdom	Common
Jews	Proper
Buddhists	Proper
option	Common
discretion	Common
canvas	Common
Parliament	Proper
states	Common
Rohatgi	Proper
favor	Common
status	Common
ramifications	Common
Law	Proper
norms	Common
Solicitor	Proper
union	Common
statute	Common
Navtej	Proper
sex	Common
arena	Common
bouquet	Common
Johar	Proper
bank	Common
accounts	Common
accommodation	Common
SCBA	Proper
Bar	Proper
facet	Common
fraternity	Common
India	Proper
Amy	Proper
Sells	Proper
Tiffany	Proper
Bosco	Proper
appellants	Common
Chelsea	Proper
McCombs	Proper
battleground	Common
Rule	Proper
disclosures	Common
elimination	Common
strikes	Common
rebuttal	Common
photos	Common
rubber	Common
trial	Common
northeast	Common
quadrant	Common
Debbie	Proper
smoking	Common
chair	Common
entertaining	Common
cigarette	Common
defense	Common
slide	Common
counsel	Common
bullet	Common
points	Common
Defense	Proper
causes	Common
instructions	Common
Counsel	Proper
crux	Common
causation	Common
spark	Common
entertainment	Common
chain	Common
benefit	Common
burns	Common
chest	Common
inch	Common
burn	Common
coils	Common
couch	Common
south	Proper
west	Common
defendants	Common
carport	Common
deadbolt	Common
lock	Common
failure	Common
violation	Common
egress	Common
exit	Common
smoke	Common
inhalation	Common
routes	Common
client	Common
alarms	Common
fine	Common
Judge	Proper
negligence	Common
Court	Proper
courts	Common
Goldsmith	Proper
Warhol	Proper
Prince	Proper
photograph	Common
Factor	Proper
balancing	Common
Circuit	Proper
precedent	Common
Soup	Proper
Cans	Proper
odds	Common
balance	Common
follow	Common
expression	Common
credit	Common
innovation	Common
copyright	Common
goal	Common
creativity	Common
stakes	Common
ruling	Common
protection	Common
museums	Common
Amendment	Proper
creator	Common
medium	Common
dramatization	Common
theater	Common
sequel	Common
brief	Common
license	Common
confusion	Common
Ms.	Proper
foundation	Common
sum	Common
copyrights	Common
Honor	Proper
JA	Proper
licensing	Common
image	Common
photographs	Common
magazines	Common
persons	Common
Hawaiʻi	Proper
SCAP-22-368	Proper
Sonia	Proper
Davis	Proper
Jessica	Proper
Lau	Proper
Lauralee	Proper
B.	Proper
Riedell	Proper
M.	Proper
Walton	Proper
plaintiffs	Common
appellees	Common
T.	Proper
Bissen	Proper
Jr.	Proper
Maui	Proper
Office	Proper
Mayor	Proper
Scott	Proper
Teruya	Proper
Finance	Proper
Bradley	Proper
Sova	Proper
Jungwook	Proper
Wookie	Proper
Kim	Proper
Argument	Common
proceeding	Common
Judiciary	Proper
ʻŌlelo	Proper
substitute	Common
justices	Common
Shanlyn	Proper
Kawashima	Proper
courthouse	Common
courtroom	Common
Counselor	Common
possession	Common
Chapter	Proper
jurisdiction	Common
steps	Common
county	Common
management	Common
Appellants	Common
notice	Common
eviction	Common
vacature	Common
belongings	Common
constitutions	Common
entitlement	Common
Lavan	Proper
existence	Common
possessions	Common
sidewalks	Common
storage	Common
facilities	Common
citations	Common
conced-	Common
chattels	Common
doubt	Common
sidewalk	Common
distinction	Common
trespass	Common
statutes	Common
protections	Common
boundary	Common
occupation	Common
race	Common
separation	Common
municipalities	Common
deOccupy	Proper
Honolulu	Proper
inventorying	Common
concession	Common
alternatives	Common
suggestion	Common
relief	Common
sweep	Common
mayor	Common
contact	Common
Distraction	Common
Cory	Proper
Doctorow	Proper
#argument	Proper
#systemanalysis	Proper
#cognitivebias	Proper
#analysis	Proper
#sharedvalues	Proper
#advice	Proper
#langu	Proper
#writinglife	Proper
Distractions	Common
Emily	Proper
boston	Proper
CC	Proper
BY-SA	Proper
readers	Common
distractions	Common
click	Common
Internet	Proper
alt	Common
tab	Common
processor	Common
tug	Common
sink	Common
distraction	Common
columns	Common
month	Common
blog	Common
posts	Common
novellas	Common
speeches	Common
aesthetics	Common
delights	Common
vice	Common
info	Common
workload	Common
muse	Common
schedule	Common
math	Common
sleep	Common
meal	Common
habit	Common
secret	Common
weekends	Common
momentum	Common
sessions	Common
keyboard	Common
push	Common
Knitters	Common
yarn	Common
knitting	Common
hint	Common
Potters	Common
clay	Common
plastic	Common
atmosphere	Common
fingers	Common
noise	Common
discomfort	Common
hunger	Common
communications	Common
tools	Common
impediment	Common
concentration	Common
ecosystem	Common
interruption	Common
IM	Common
email	Common
alerts	Common
RSS	Proper
Skype	Proper
rings	Common
etc.	Common
conversation	Common
chat	Common
voice	Common
desk	Common
Jobs	Common
Barnes	Proper
#reportinginformation	Proper
#logos	Proper
#ethos	Proper
#pathos	Proper
#kairos	Proper
#currentevents	Proper
#causalargument	Proper
#proposal	Proper
#finances	Proper
Photo	Common
Laity	Proper
Family	Proper
prerequisite	Common
survival	Common
income	Common
liberals	Common
Tobin	Proper
John	Proper
Kenneth	Proper
Galbraith	Proper
McGovern	Proper
conservatives	Common
Friedrich	Proper
Hayek	Proper
Milton	Proper
Friedman	Proper
Nixon	Proper
Monopoly	Proper
payments	Common
Go	Proper
welfare	Common
redistribution	Common
taxes	Common
Jay	Proper
Hammond	Proper
governor	Common
Alaska	Proper
thinker	Common
legislators	Common
dividends	Common
resource	Common
Slope	Proper
oil	Common
proceeds	Common
Fund	Proper
resident	Common
Alaskans	Proper
earnings	Common
poverty	Common
formula	Common
wealth	Common
dividend	Common
enrollment	Common
pennies	Common
Security	Proper
jiffy	Common
revenue	Common
Dividends	Proper
chunk	Common
permits	Common
carbon	Common
patent	Common
airwaves	Common
debt	Common
midlife	Common
retiree	Common
boost	Common
shortage	Common
patriot	Common
Paine	Proper
Creator	Proper
universe	Common
invention	Common
birthright	Common
charity	Common
lump	Common
stipend	Common
Revenue	Common
landowners	Common
feat	Common
imagination	Common
infrastructures	Common
corporations	Common
co-ownership	Common
tendencies	Common
capitalism	Common
plutocracy	Common
market	Common
prosperity	Common
dreaming	Common
suffrage	Common
march	Common
changer	Common
Harvest	Proper
Produce	Common
Pandolfi	Proper
Nicco	Proper
#valuesbased	Proper
#descriptive	Proper
#food	Proper
peas	Common
Marco	Proper
Verch	Proper
BY	Proper
freezer	Common
colleague	Common
food	Common
berries	Common
greens	Common
freshness	Common
soups	Common
stocks	Common
forethought	Common
produce	Common
foods	Common
foodies	Common
substitutes	Common
sentiments	Common
pitches	Common
soldiers	Common
Food	Common
Waste	Common
Pitch	Common
Nations	Proper
Agriculture	Proper
Organization	Proper
waste	Common
countries	Common
fruits	Common
vegetables	Common
distributor	Common
widgets	Common
knick	Common
knacks	Common
pre-season	Common
crop	Common
planning	Common
outlets	Common
batch	Common
lb	Common
freezing	Common
producers	Common
percentage	Common
yield	Common
Growers	Common
arrangements	Common
processors	Common
inventory	Common
mid-season	Common
farmers	Common
farms	Common
businesses	Common
stewardship	Common
innovators	Common
multiplier	Common
chains	Common
circulation	Common
foodshed	Common
opportunities	Common
growers	Common
streams	Common
farm	Common
harvest	Common
chefs	Common
Time	Common
distributors	Common
kitchen	Common
spaces	Common
geography	Common
choices	Common
impacts	Common
calories	Common
eaters	Common
goods	Common
flooding	Common
storms	Common
disasters	Common
obstacles	Common
pinch	Common
supply	Common
disenfranchisement	Common
deserts	Common
reserves	Common
resilience	Common
Quality	Common
none	Common
dressing	Common
stand-ins	Common
counterparts	Common
credence	Common
approval	Common
realms	Common
flavor	Common
nutrition	Common
stigma	Common
respondents	Common
connotations	Common
increase	Common
fringe	Common
cousins	Common
nutrients	Common
shot	Common
clock	Common
ubiquitousness	Common
fodder	Common
marketing	Common
options	Common
northwest	Common
Goodwill	Proper
Industries	Proper
Farm	Proper
Freezer	Proper
program	Common
batches	Common
grocers	Common
Oryana	Proper
Foods	Proper
Co	Proper
Op	Proper
Cherry	Proper
Capital	Proper
strawberries	Common
Ware	Proper
Benzie	Proper
CSAs	Common
Providence	Proper
fruit	Common
add	Common
shares	Common
realities	Common
Anime	Proper
Shell	Proper
Maynard	Proper
#review	Proper
#technology	Proper
Motoko	Proper
Kusanagi	Proper
cosplay	Common
GEMMA	Proper
DENISE	Proper
NC	Proper
ND	Proper
anime	Common
Microsoft	Proper
GUI	Common
doldrums	Common
grips	Common
augmentation	Common
AI	Proper
Films	Proper
Future	Proper
Technology	Proper
Morality	Proper
Sci	Proper
Fi	Proper
Movies	Proper
Mango	Proper
Publishing	Proper
landscape	Common
Identity	Common
cyborg	Common
operative	Common
hacker	Common
Puppet	Proper
ghost	Common
machine	Common
interfaces	Common
hackers	Common
leash	Common
handlers	Common
asylum	Common
masters	Common
entity	Common
heart	Common
Yoshida	Proper
Beginner	Proper
Guide	Proper
meditation	Common
consciousness	Common
ruts	Common
Elon	Proper
Musk	Proper
company	Common
Neuralink	Proper
laces	Common
Iain	Proper
Banks	Proper
Twitter	Proper
lace	Common
humanity	Common
symbiosis	Common
machines	Common
radar	Common
breakthroughs	Common
optogenetics	Common
internet	Common
capabilities	Common
risk	Common
tech	Common
implants	Common
doubts	Common
augmentations	Common
worth	Common
illusion	Common
autonomy	Common
upgrade	Common
athlete	Common
Oscar	Proper
Pistorius	Proper
runner	Common
racing	Common
blades	Common
promise	Common
enhancements	Common
fears	Common
researcher	Common
Mann	Proper
advocate	Common
Hugo	Proper
Campos	Proper
defibrillator	Common
tension	Common
angst	Common
tip	Common
iceberg	Common
borders	Common
truths	Common
Let	Proper
Minority	Proper
Report	Proper
Ex	Proper
Machina	Proper
ghosts	Common
drive	Common
Sex	Common
Forbes	Proper
Eaton	Proper
Krueger	Proper
Miri	Proper
Nicholas	Proper
#research	Proper
#health	Proper
Couple	Proper
MacKenzie	Proper
finances	Common
bonds	Common
mastery	Common
pattern	Common
adults	Common
sexuality	Common
majority	Common
epidemic	Common
frigidity	Common
nosedive	Common
attitudes	Common
'60's	Common
'70's	Common
ages	Common
questionnaires	Common
mail	Common
encounters	Common
priorities	Common
predictors	Common
decline	Common
partners	Common
benefits	Common
preferences	Common
likes	Common
dislikes	Common
pleasure	Common
declines	Common
expectancy	Common
lifespan	Common
Psychiatry	Proper
Minnesota	Proper
SUNY	Proper
Conversation	Proper
SA	Proper
Commons	Proper
Attribution	Proper
Share	Proper
License	Common
Claus	Proper
Alex	Proper
Betty	Proper
asshole	Common
glaze	Common
wrinkles	Common
headset	Common
neck	Common
marine	Common
buddies	Common
profanity	Common
bass	Common
gunfire	Common
Xbox	Proper
Cleveland	Proper
coverage	Common
miracle	Common
travel	Common
fireplaces	Common
explosions	Common
lawsuits	Common
heels	Common
ops	Common
garlic	Common
yams	Common
tune	Common
Gomez	Proper
Glock	Proper
drug	Common
dealer	Common
ham	Common
maple	Common
Patty	Proper
Smyth	Proper
Goodbye	Common
bursts	Common
rifle	Common
eggnog	Common
envelopes	Common
V	Common
undershirt	Common
pants	Common
belly	Common
neckhole	Common
trail	Common
armholes	Common
robe	Common
mortality	Common
doll	Common
belt	Common
waist	Common
bills	Common
currency	Common
pocket	Common
shouting	Common
mosaic	Common
snowscape	Common
HDTV	Common
blinds	Common
landmine	Common
pans	Common
potatoes	Common
gingerbread	Common
batter	Common
fight	Common
stink	Common
jingle	Common
bell	Common
cell	Common
Nutcrackers	Common
Ginny	Proper
secretary	Common
towel	Common
microphone	Common
Moroz	Proper
Humpty	Proper
mic	Common
phone	Common
girdle	Common
button	Common
arrow	Common
diving	Common
tree	Common
heaven	Common
sake	Common
Tyler	Proper
grandmother	Common
gaps	Common
Easter	Proper
lightness	Common
spirit	Common
singing	Common
bench	Common
warmth	Common
grief	Common
intensity	Common
childhood	Common
maturity	Common
strength	Common
depth	Common
shins	Common
face	Common
religion	Common
mystery	Common
basement	Common
attic	Common
insecurities	Common
ignorance	Common
album	Common
discovery	Common
cascade	Common
revelations	Common
dining	Common
coffee	Common
feelings	Common
abandonment	Common
storybooks	Common
realization	Common
aura	Common
emptiness	Common
Cara	Proper
Dillard	Proper
cashier	Common
mall	Common
asthma	Common
attack	Common
cookie	Common
Shelby	Proper
Shetland	Proper
Sheepdog	Proper
treat	Common
M&M	Proper
Mountain	Proper
Dew	Proper
deck	Common
cards	Common
fish	Common
match	Common
silk	Common
Toph	Proper
chocolate	Common
Spencer	Proper
shoulders	Common
gym	Common
shorts	Common
underwear	Common
inhaler	Common
lungs	Common
booster	Common
seat	Common
driveway	Common
Emergency	Common
Joyce	Proper
girlfriend	Common
nerves	Common
while	Common
sandwich	Common
roughhousing	Common
garage	Common
hair	Common
garden	Common
drops	Common
rain	Common
stones	Common
sky	Common
mineral	Common
breath	Common
belief	Common
leaf	Common
grass	Common
stems	Common
folds	Common
blue	Common
sight	Common
spattering	Common
shoots	Common
tendrils	Common
humus	Common
vapour	Common
trails	Common
porch	Common
downfall	Common
torrents	Common
tapping	Common
roof	Common
roar	Common
Pools	Common
lawn	Common
raspberry	Common
canes	Common
flower	Common
beds	Common
Earthworms	Common
haven	Common
Water	Common
barrels	Common
eaves	Common
gutters	Common
pathways	Common
stairs	Common
planks	Common
raft	Common
beat	Common
logs	Common
leaves	Common
Waves	Common
boxes	Common
bowls	Common
basket	Common
cuttings	Common
river	Common
street	Common
rooftops	Common
hallway	Common
rocks	Common
mermaids	Common
crest	Common
voices	Common
winds	Common
salt	Common
preparation	Common
seaweed	Common
locks	Common
reach	Common
flick	Common
elbows	Common
socks	Common
tide	Common
worm	Common
wake	Common
tiles	Common
chimney	Common
stacks	Common
downpour	Common
blues	Common
greys	Common
white	Common
waters	Common
whale	Common
clouds	Common
maw	Common
chimneys	Common
barnacles	Common
cockles	Common
creaking	Common
cracking	Common
patch	Common
troughs	Common
crests	Common
sails	Common
galleon	Common
masts	Common
timbers	Common
mermaid	Common
bow	Common
ship	Common
wash	Common
rope	Common
sailors	Common
net	Common
jewels	Common
finery	Common
pillagings	Common
Giants	Proper
marble	Common
mausoleum	Common
husband	Common
mud	Common
riverboatmen	Common
linen	Common
shrouds	Common
graveyards	Common
farmland	Common
delta	Common
hills	Common
granddaughter	Common
dress	Common
brocade	Common
patio	Common
disrepute	Common
young	Common
grandmothers	Common
waterfront	Common
dockworkers	Common
mah	Common
jongg	Common
giants	Common
rouge	Common
creases	Common
traveler	Common
crow	Common
hanks	Common
soot	Common
red	Common
triumph	Common
delight	Common
streets	Common
smell	Common
docks	Common
bits	Common
debris	Common
massage	Common
trees	Common
sunlight	Common
pack	Common
courtyard	Common
heap	Common
loaves	Common
flatbread	Common
olives	Common
cheese	Common
clothes	Common
pills	Common
glasses	Common
jug	Common
wine	Common
can-teen	Common
shadow	Common
blanket	Common
vineyards	Common
noons	Common
frustration	Common
knots	Common
Prologue	Common
Kethlan	Proper
remnants	Common
empire	Common
mistakes	Common
galaxy	Common
billions	Common
starfighter	Common
metal	Common
graveyard	Common
Jacques	Proper
Chalmers	Proper
anxiety	Common
calibration	Common
cockpit	Common
comfort	Common
ships	Common
Enemy	Proper
frontline	Common
Forces	Proper
footage	Common
battleships	Common
hill	Common
starfighters	Common
locusts	Common
pursuers	Common
flight	Common
deployment	Common
carrier	Common
pilots	Common
ears	Common
fighter	Common
names	Common
cockpits	Common
helmets	Common
deaths	Common
fighters	Common
catapult	Common
stand	Common
Imperium	Proper
Hundreds	Common
cities	Common
planets	Common
Pandorans	Proper
mistake	Common
CO	Proper
visions	Common
row	Common
emblem	Common
breast	Common
helmet	Common
heads	Common
spheres	Common
groove	Common
scowl	Common
ruby	Common
Daniels	Proper
Peterson	Proper
Foster	Proper
Brown	Proper
Rye	Proper
Feet	Common
stomach	Common
doom	Common
hope	Common
Flynn	Proper
Golden	Proper
Blair	Proper
protest	Common
ladder	Common
Zombie	Common
switches	Common
buttons	Common
confirmations	Common
screens	Common
Moments	Common
craft	Common
thick	Common
Moon	Proper
moon	Common
scenes	Common
flowers	Common
seas	Common
foliage	Common
dreams	Common
crystal	Common
stream	Common
ripples	Common
currents	Common
oceans	Common
banks	Common
lotos	Common
blossoms	Common
shore	Common
fear	Common
lure	Common
vistas	Common
shrubs	Common
idols	Common
pagodas	Common
bendings	Common
bridges	Common
lips	Common
marshes	Common
reeds	Common
beaches	Common
sand	Common
perfumes	Common
nets	Common
secrets	Common
spires	Common
festoons	Common
dead	Common
condor	Common
reef	Common
towers	Common
roofs	Common
nostrils	Common
perfume	Common
stench	Common
spot	Common
flesh	Common
churchyards	Common
worms	Common
horrors	Common
writhing	Common
chill	Common
afar	Common
rim	Common
basalt	Common
crown	Common
eikon	Common
forehead	Common
moonlight	Common
ooze	Common
slinking	Common
shallows	Common
Oversite	Common
Gram	Proper
Renata	Proper
sleeve	Common
muscle	Common
biceps	Common
examining	Common
Alzheimer	Proper
implant	Common
antiseptic	Common
lidocaine	Common
injection	Common
chip	Common
gun	Common
grade	Common
nights	Common
parking	Common
Freud	Proper
olds	Common
couches	Common
retriever	Common
sticks	Common
dream	Common
past	Common
Ted	Proper
Bundy	Proper
scramblers	Common
Rorschach	Proper
Theseus	Proper
vampires	Common
Fireflies	Proper
Paglino	Proper
outcasts	Common
misfortune	Common
genotype	Common
nearsightedness	Common
acne	Common
susceptibility	Common
narcotics	Common
TwenCen	Proper
relics	Common
handiwork	Common
playground	Common
Pag	Proper
taunts	Common
mongrel	Common
polly	Common
blows	Common
attackers	Common
act	Common
defiance	Common
sandbox	Common
buddy	Common
backup	Common
sentry	Common
violence	Common
seizures	Common
distance	Common
stranger	Common
insults	Common
route	Common
B	Proper
wiring	Common
algorithms	Common
weaklings	Common
midst	Common
superboys	Common
ribs	Common
propaganda	Common
empathy	Common
underdog	Common
fist	Common
assailants	Common
backs	Common
threat	Common
blow	Common
cheek	Common
satisfaction	Common
zombie	Common
irony	Common
remark	Common
other	Common
ball	Common
Blood	Common
fours	Common
reinforcements	Common
fists	Common
Siri	Proper
fuckwad	Common
ep	Common
epilepsy	Common
Daisy	Proper
Willett	Proper
Manhattan	Proper
tub	Common
crossword	Common
clang	Common
radiators	Common
swish	Common
taxis	Common
slush	Common
reverie	Common
squawk	Common
bathroom	Common
splash	Common
tile	Common
thump	Common
hall	Common
bathtub	Common
soap	Common
nylon	Common
pixies	Common
drain	Common
lever	Common
squeak	Common
sugarcane	Common
polish	Common
puppy	Common
lip	Common
footprints	Common
wood	Common
Ichor	Common
pixie	Common
brunt	Common
baths	Common
soup	Common
dishes	Common
Ramon	Proper
McMasters	Proper
5C	Proper
equinox	Common
super	Common
boiler	Common
buzzers	Common
yoga	Common
navel	Common
Francisco	Proper
earthquakes	Common
sprites	Common
Gate	Proper
bruise	Common
butt	Common
karma	Common
press	Common
Things	Common
Dog	Common
Back	Common
Rachel	Proper
Rook	Proper
Carroll	Proper
abandon	Common
weekend	Common
picnickers	Common
tourists	Common
exam	Common
nails	Common
outfit	Common
mirror	Common
crease	Common
talent	Common
admiration	Common
lust	Common
Jellicoh	Proper
weekday	Common
bike	Common
library	Common
checkout	Common
Tristram	Proper
Shandy	Proper
graduate	Common
Sunlight	Common
hairs	Common
collar	Common
rectangle	Common
thumb	Common
forefinger	Common
Pages	Common
tatters	Common
spine	Common
Title	Common
binding	Common
joke	Common
Pete	Proper
halt	Common
wheel	Common
fairy	Common
itching	Common
tissue	Common
Lots	Common
goo	Common
disgust	Common
handkerchief	Common
remarks	Common
finger	Common
reply	Common
insect	Common
trick	Common
leprechauns	Common
noggins	Common
moans	Common
exams	Common
answers	Common
Idiot	Common
spider	Common
palm	Common
wishes	Common
flash	Common
END	Common
Justine	Proper
Larbalestier	Proper
Fairy	Proper
tales	Common
Vision	Proper
sickness	Common
travelling	Common
saddle	Common
fashion	Common
dials	Common
dial	Common
levers	Common
indicators	Common
futurity	Common
greyness	Common
succession	Common
pace	Common
alternations	Common
sun	Common
last	Common
twilight	Common
comet	Common
darkling	Common
trace	Common
circling	Common
horizon	Common
dome	Common
extinction	Common
slowing	Common
drag	Common
outlines	Common
beach	Common
blackness	Common
scarlet	Common
hull	Common
vegetation	Common
green	Common
forest	Common
moss	Common
lichen	Common
caves	Common
plants	Common
breakers	Common
swell	Common
breathing	Common
margin	Common
incrustation	Common
oppression	Common
sensation	Common
mountaineering	Common
scream	Common
butterfly	Common
hillocks	Common
crab	Common
creature	Common
claws	Common
antennæ	Common
carters	Common
whips	Common
bosses	Common
palps	Common
Cost	Proper
Veronique	Proper
blankets	Common
furs	Common
dark	Common
teacher	Common
Earth	Proper
lingua	Common
anthropologist	Common
offworlders	Common
touch	Common
Anneal	Proper
Kumar	Proper
peoples	Common
clans	Common
Mam	Proper
Bet	Proper
Scathalos	Proper
outrunners	Common
offworlder	Common
stabros	Common
hero	Common
drinking	Common
shooting	Common
Rosencreutz	Proper
ROMANCE	Proper
EIGHT	Proper
DAYS	Proper
JOHANN	Proper
VALENTIN	Proper
ANDREAE	Proper
JOHN	Proper
CROWLEY	Proper
THEO	Proper
FADEL	Proper
BEER	Proper
PRESS	Common
EASTHAMPTON	Proper
MASS	Proper
versions	Common
Valentin	Proper
Andreae	Proper
Max	Proper
Ernst	Proper
illustrations	Common
prayers	Common
Maker	Proper
Father	Proper
Lights	Proper
wafer	Common
Paschal	Proper
Lamb	Proper
human	Common
coat	Common
heavens	Common
Dante	Proper
Comedy	Proper
allegory	Common
resurrection	Common
puzzles	Common
deer	Common
DAY	Common
images	Common
inscriptions	Common
trumpets	Common
procession	Common
king	Common
chamber	Common
lion	Common
fountain	Common
spirits	Common
sword	Common
plaque	Common
monuments	Common
Hermes	Proper
humankind	Common
harm	Common
god	Common
balm	Common
Brethren	Common
Biologist	Common
Bos	Proper
Wikinews	Proper
ants	Common
Tuesday	Proper
file	Common
Image	Common
Mathias	Proper
Krumbholz	Proper
Helsinki	Proper
adaptations	Common
insects	Common
parasite	Common
Evolution	Proper
ant	Common
species	Common
aphid	Common
honeydew	Common
stumps	Common
fungus	Common
hydrogen	Common
peroxide	Common
Hydrogen	Common
fatalities	Common
intake	Common
wild	Common
aphids	Common
Independent	Proper
Copenhagen	Proper
AntyScience	Proper
pun	Common
topic	Common
jargon	Common
cicada	Common
Bolivia	Proper
Danny	Proper
Newman	Proper
studymate	Common
beetles	Common
butterflies	Common
mantids	Common
nest	Common
Biology	Common
internship	Common
M.Sc.	Proper
professors	Common
Ants	Common
supervision	Common
Prof.	Proper
Patrizia	Proper
d'Ettorre	Proper
budget	Common
setups	Common
Nickinator	Proper
i-Nick	Proper
Nicktendo64	Proper
trunks	Common
logging	Common
sites	Common
Finland	Proper
nests	Common
Y	Common
tong	Proper
concrete	Common
squares	Common
CD	Common
tunnel	Common
foraging	Common
cloth	Common
Example	Common
Bernardini	Proper
ROS	Proper
Oxygen	Proper
Species	Proper
spectrophotometer	Common
spores	Common
concentrations	Common
petri	Proper
agar	Common
experiment	Common
experimenter	Common
Brotherhood	Proper
Magicians	Proper
Magic	Proper
Evans	Proper
magic	Common
tricks	Common
dragons	Common
magician	Common
Scarne	Proper
Card	Proper
Tricks	Proper
influences	Common
Burger	Proper
Skinner	Proper
magicians	Common
hobby	Common
monkey	Common
Jeff	Proper
McBride	Proper
Experience	Proper
Eureka	Proper
Springs	Proper
Arkansas	Proper
Las	Proper
Vegas	Proper
Midwest	Proper
Jubilee	Proper
TAOM	Proper
Dallas	Proper
Convention	Proper
Buxton	Proper
Italy	Proper
Magi	Proper
Fest	Proper
Winter	Proper
Carnival	Proper
Tennessee	Proper
Cavalcade	Proper
FFFF	Proper
File	Common
David	Proper
Gish	Proper
props	Common
Budd	Proper
Interview	Proper
activist	Common
philosopher	Common
Saturday	Proper
Philosophy	Common
Vietnam	Proper
Socialist	Common
Hegemony	Proper
Survival	Proper
bestseller	Common
non-fiction	Common
Arts	Proper
Humanities	Proper
Citation	Proper
Index	Proper
scholar	Common
Dranove	Proper
MIT	Proper
NATO	Proper
protests	Common
counter-conference	Common
talks	Common
alliance	Common
aggression	Common
Soviet	Proper
Union	Proper
Gorbachev	Proper
U.S	Proper
Bush	Proper
administration	Common
east	Proper
zone	Common
weapons	Common
basis	Common
Clinton	Proper
pledge	Common
strike	Common
remilitarization	Common
militarism	Common
missile	Common
Czechoslovakia	Proper
provocation	Common
deterrent	Common
weapon	Common
missiles	Common
Obama	Proper
Marine	Proper
commandant	Common
Hoop	Proper
Scheffer	Proper
pipelines	Common
lanes	Common
guarantor	Common
supplies	Common
Labor	Common
revival	Common
Left	Proper
signs	Common
1930’s	Proper
ownership	Common
factory	Common
Republic	Proper
Windows	Proper
Doors	Proper
Factory	Proper
scope	Common
Santorum	Proper
cocktail	Common
owners	Common
beverage	Common
santorum	Common
neologism	Common
columnist	Common
Savage	Proper
column	Common
Pennsylvania	Proper
Senator	Proper
Rick	Proper
homosexuality	Common
mixture	Common
lube	Common
byproduct	Common
Background	Common
parody	Common
Morning	Common
Breakfast	Proper
Cereal	Common
webcomic	Common
Weiner	Proper
Standard	Proper
Brooklyn	Proper
Stan	Proper
Rauschenberg	Proper
polls	Common
Paper	Proper
ingredients	Common
vodka	Common
Baileys	Proper
Irish	Proper
Cream	Proper
Angostura	Proper
bitters	Common
Godiva	Proper
flakes	Common
bartender	Common
customer	Common
Troy	Proper
Slate	Proper
Magazine	Proper
pucker	Common
Press	Proper
bestiality	Common
SpreadingSantorum.com	Proper
spread	Common
searches	Common
dominance	Common
engines	Common
Bing	Proper
Yahoo!	Proper
prevalence	Common
assessment	Common
filth	Common
mainstream	Common
product	Common
primary	Common
satire	Common
pros	Common
Jezebel	Proper
Metro.us	Proper
EDGE	Proper
Net	Proper
Instinct	Proper
customers	Common
dessert	Common
cream	Common
pie	Common
publicity	Common
Marymegan	Proper
Daly	Proper
anemone	Common
Rack	Proper
Antarctica	Proper
hopes	Common
identification	Common
expectation	Common
trip	Common
biologists	Common
ANDRILL	Proper
geologists	Common
anemones	Common
antifreeze	Common
glow	Common
ROV	Common
difficulties	Common
specimens	Common
formalin	Common
formaldehyde	Common
structures	Common
DNA	Common
chemistry	Common
genome	Common
transcriptome	Common
metabolome	Common
tests	Common
burrows	Common
comparisons	Common
animal	Common
beasts	Common
luminescence	Common
proteins	Common
magnification	Common
slices	Common
microtome	Common
slides	Common
muscles	Common
capsules	Common
nematocysts	Common
'scopes	Common
recovery	Common
projects	Common
queue	Common
tag	Common
schedules	Common
Manuscript	Common
preservatives	Common
specimen	Common
preservation	Common
genes	Common
clones	Common
Ice	Proper
Shelf	Proper
localities	Common
McMurdo	Proper
Station	Proper
Daily	Proper
BDSM	Common
dungeon	Common
Clothing	Common
closet	Common
misconception	Common
snippets	Common
black	Common
rooms	Common
accouterments	Common
feeling	Common
ads	Common
S&M	Common
ad	Common
Wow	Common
startup	Common
rents	Common
build-outs	Common
hiring	Common
advertising	Common
bulk	Common
wear	Common
tear	Common
maintenance	Common
bookkeeping	Common
gals	Common
Magazines	Common
policy	Common
Voice	Proper
Personality	Proper
mistresses	Common
psychologist	Common
leg	Common
asses	Common
profile	Common
mini-MMPI	Proper
Rebecca	Proper
chart	Common
MMPI	Proper
baseline	Common
profiles	Common
amalgamation	Common
O.J.	Proper
Simpson	Proper
indicator	Common
IQ	Common
Herrick	Proper
wikiHow	Proper
RecentChangesCamp	Proper
ShakataGaNai	Proper
wiki	Common
how	Common
manual	Common
HyperLink	Proper
readership	Common
Wikipedia	Proper
visitors	Common
Analytics	Proper
Quantcast	Proper
Note	Common
milestone	Common
Mediawiki	Proper
volunteers	Common
respects	Common
admins	Common
editor	Common
advantages	Common
disadvantages	Common
Wikimedia	Proper
Foundation	Proper
opt	Common
donations	Common
meetups	Common
charities	Common
http://www.wikihow.com/wikiHow:Contributions-to-Charity	Proper
offsets	Common
http://www.wikihow.com/wikiHow:Carbon-Neutral	Proper
wikiLove	Common
civility	Common
individual	Common
Knowledge	Common
eHow	Proper
advertisers	Common
markets	Common
sacrifices	Common
breadth	Common
http://www.wikihow.com/wikiHow:Right-to-Fork	Proper
websites	Common
Source	Common
GPL	Proper
volunteer	Common
users	Common
GNU	Common
Document	Common
Driver	Common
retrospect	Common
minimum	Common
wikis	Common
http://www.wikihow.com/wikiHow:Statistics	Proper
http://www.quantcast.com/wikihow.com	Proper
circle	Common
editing	Common
Ličen	Proper
Paralympics	Proper
stamp	Common
Sochi	Proper
Leadership	Proper
Management	Proper
sport	Common
contents	Common
Slovenia	Proper
Director	Proper
Media	Proper
Communications	Proper
WTA	Proper
Tour	Proper
UNESCO	Proper
Commission	Proper
Manager	Common
wheelchair	Common
basketball	Common
visibility	Common
Canada	Proper
dedication	Common
qualifications	Common
ethnicity	Common
nationality	Common
athletes	Common
disability	Common
sports	Common
masculinity	Common
males	Common
perseverance	Common
contexts	Common
Disabilities	Proper
channels	Common
NBC	Proper
broadcasting	Common
cable	Common
hour	Common
Coast	Proper
daytime	Common
broadcasters	Common
competitions	Common
pity	Common
multitude	Common
expectations	Common
LibriVox	Proper
McGuire	Proper
podcasters	Common
Conrad	Proper
Agent	Proper
AKMA	Proper
Lawrence	Proper
Lessig	Proper
audiobooks	Common
favourite	Common
Notes	Proper
Underground	Proper
Dostoyevsky	Proper
Austen	Proper
Jane	Proper
Pride	Proper
Prejudice	Proper
Christie	Proper
Agatha	Proper
Affair	Proper
Styles	Proper
Macaulay	Proper
Babington	Proper
Volume	Proper
Marx	Proper
Karl	Proper
Engels	Proper
Manifesto	Proper
Twain	Proper
Connecticut	Proper
Yankee	Proper
Ed.	Common
index	Common
audio	Common
poem	Common
Creative	Proper
licenses	Common
Larry	Proper
print	Common
titles	Common
O'Reilly	Proper
simplicity	Common
podiobooks.com	Proper
beer	Common
Content	Proper
Definition	Proper
texts	Common
pay	Common
LV	Proper
tome	Common
XML	Proper
Preston	Proper
Victoria	Proper
Tina	Proper
McKenzie	Proper
Gliders	Proper
silver	Common
bronze	Common
medalist	Common
cafe	Common
Melbourne	Proper
suburb	Common
Spitfire	Proper
Tournament	Proper
tournament	Common
trips	Common
teams	Common
Championship	Proper
occurrence	Common
Cups	Proper
competition	Common
Committee	Proper
Messina	Proper
Mets	Proper
Poet	Proper
Jackson	Proper
readings	Common
concerts	Common
twenties	Common
tidbit	Common
coffeehouses	Common
Motion	Proper
musicians	Common
autograph	Common
CDs	Common
late	Common
depths	Common
adversity	Common
Walt	Proper
Whitman	Proper
telegram	Common
poems	Common
drums	Common
ferry	Common
boats	Common
Jersey	Proper
Ground	Common
Zero	Proper
stanza	Common
occasion	Common
Failure	Common
Victory	Proper
Shea	Proper
hesitation	Common
reward	Common
patrons	Common
e-mail	Common
successes	Common
failures	Common
section	Common
stadium	Common
banner	Common
playoffs	Common
eggshells	Common
ticket	Common
holder	Common
hug	Common
tears	Common
SNY	Proper
jersey	Common
nickname	Common
Birdman	Proper
Birdie	Proper
Onion	Proper
journalism	Common
reporter	Common
headline	Common
Monday	Proper
drafts	Common
photojournalism	Common
headlines	Common
Writers	Common
Britney	Proper
Spears	Proper
Chet	Proper
Clem	Proper
Sean	Proper
Mills	Proper
Shankbone	Proper
AM	Proper
zeitgeist	Common
portrayal	Common
Terry	Proper
Stephen	Proper
Colbert	Proper
Kennedy	Proper
Lopez	Proper
J	Proper
Lo	Proper
Weekly	Proper
take	Common
traffic	Common
analogy	Common
Rob	Proper
Siegel	Proper
chief	Common
tasting	Common
laugh	Common
Studio	Common
Rock	Proper
Broadway	Proper
Israel	Proper
victims	Common
Shimon	Proper
Peres	Proper
Peace	Common
fathers	Common
ink	Common
Armies	Common
Customs	Common
distances	Common
Palestinians	Proper
Arabs	Proper
generations	Common
terrorists	Common
modernity	Common
nationalities	Common
patience	Common
histories	Common
values	Common
elephants	Common
Hannibal	Proper
Alps	Proper
helicopters	Common
Cleopatra	Proper
noses	Common
prejudices	Common
commitments	Common
GNP	Common
Saudis	Proper
adage	Common
Mistake	Common
beings	Common
Darfur	Proper
battles	Common
futures	Common
continuation	Common
Turkey	Proper
doors	Common
Aner	Proper
Shalev	Proper
Kibbutz	Proper
Kinneret	Proper
Tiberias	Proper
Jerusalem	Proper
Levico	Proper
Terme	Proper
Trento	Proper
Character	Proper
walks	Proper
symmetry	Common
conjectures	Common
beauty	Common
worlds	Common
surprises	Common
Lewis	Proper
Carrol	Proper
Alice	Proper
Wonderland	Proper
psychoanalysis	Common
Opus	Proper
Legato	Proper
Staccato	Proper
breaks	Common
opening	Common
Overtures	Common
Matters	Proper
scapes	Common
Achilles	Proper
turtle	Common
tragedies	Common
narrator	Common
emails	Common
Eva	Proper
distortions	Common
forth	Common
Westphal	Proper
Stardust	Proper
capsule	Common
81P/Wild	Proper
Wild	Proper
SETI	Proper
IOTM	Proper
IRC	Proper
Artist	Common
rendering	Common
Spacecraft	Proper
missions	Common
Vilt	Proper
discoverer	Common
Apollo	Proper
Genesis	Proper
Galaxy	Common
POV	Common
rocket	Common
JPL	Proper
pad	Common
trajectory	Common
dust	Common
particles	Common
micron	Common
collector	Common
particle	Common
tenth	Common
meter	Common
astrophysics	Common
Cosmic	Proper
Dust	Common
Building	Proper
ARES	Proper
Rocks	Common
chips	Common
Meteorites	Common
Particles	Common
U2	Proper
stratosphere	Common
aerogel	Common
Microscope	Proper
html	Common
javascript	Common
browsers	Common
downloads	Common
tracks	Common
Aerogel	Common
slice	Common
blade	Common
Galileo	Proper
Ulysses	Proper
spacecraft	Common
detectors	Common
Eberhard	Proper
Gruen	Proper
flux	Common
Markus	Proper
Landgraf	Proper
periods	Common
cruise	Common
millionth	Common
microns	Common
diameter	Common
demo	Common
VM	Proper
submicron	Common
carbonyl	Common
accelerator	Common
speeds	Common
Sept	Proper
Roy	Proper
Stinebower	Proper
copies	Common
carbons	Common
hurry	Common
Lionel	Proper
Bert	Proper
Trieste	Proper
LE	Proper
Conference	Proper
commissions	Common
meetings	Common
Powers	Proper
delays	Common
completion	Common
Flying	Proper
Dutchman	Proper
Vaisseau	Proper
Phantome	Proper
singers	Common
boat	Common
foreground	Common
disappearance	Common
silhouette	Common
ballet	Common
Luxembourg	Proper
meals	Common
restaurant	Common
delegates	Common
Thurday	Proper
Shaganon	Proper
meeting	Common
subcommission	Common
frontier	Common
grants	Common
Otto	Proper
Guthe	Proper
geographer	Common
mile	Common
mountain	Common
Severin	Proper
Pauvre	Proper
Notre	Proper
faculties	Common
Sainte	Proper
Chapelle	Proper
north	Common
purple	Common
Reinstein	Proper
delegation	Common
drinks	Common
sandwiches	Common
nuts	Common
PX	Proper
Sugarbowl	Proper
milkshakes	Common
sundaes	Common
ices	Common
icecreams	Common
A.M.	Common
sunshine	Common
CONGRESSMAN	Common
REPORT	Common
JAMES	Proper
ABOUREZK	Proper
DISTRICT	Proper
SOUTH	Proper
DAKOTA	Proper
CANNON	Proper
HOUSE	Proper
OFFICE	Proper
BUILDING	Proper
TELEPHONE	Common
LETTER	Common
PEOPLE	Common
FLOOD	Common
AREA	Common
Friends	Proper
lady	Common
Estimates	Common
antiques	Common
mortgage	Common
Disaster	Common
Relief	Proper
homeowners	Common
businessmen	Common
flood	Common
loan	Common
cash	Common
legislation	Common
rebuilding	Common
loans	Common
package	Common
Congressmen	Proper
prospects	Common
disaster	Common
laws	Common
chances	Common
appraisal	Common
Legislation	Common
SBA	Proper
provisions	Common
Works	Proper
Subcommittee	Proper
hearings	Common
forgiveness	Common
increases	Common
recreation	Common
Government	Proper
tourist	Common
fairness	Common
Committees	Proper
agencies	Common
Cannon	Proper
ray	Common
Abourezk	Proper
Member	Proper
expense	Common
Mikhail	Proper
Republics	Proper
economists	Common
nations	Common
economies	Common
trade	Common
enterprises	Common
losses	Common
danger	Common
incomes	Common
sales	Common
share	Common
formation	Common
allocation	Common
rental	Common
provision	Common
component	Common
roads	Common
transit	Common
telephones	Common
sewers	Common
prices	Common
rentals	Common
auction	Common
purchase	Common
resale	Common
speculators	Common
profits	Common
inequity	Common
dissatisfaction	Common
offers	Common
investors	Common
aversion	Common
advance	Common
heritage	Common
duration	Common
abuse	Common
capita	Common
endowments	Common
managers	Common
Users	Common
justice	Common
Jan.	Proper
mum	Common
vacation	Common
Wesleyan	Proper
Syracuse	Proper
grapefruit	Common
Bonde	Proper
refrig.	Common
expenses	Common
Wed.	Proper
Feb.	Proper
shutter	Common
settings	Common
Adelle	Proper
Rats	Common
Wila	Proper
Marcie	Proper
Kittie	Proper
Slacks	Common
Miss	Proper
Rickenbacker	Proper
Abbot	Proper
Andover	Proper
Ash	Proper
Thurs.	Proper
delay	Common
probabition	Common
Math	Common
B-	Common
Tues.	Proper
nite	Common
mark	Common
comp.	Common
Arosa	Proper
comps.	Common
confer.	Common
after	Common
C	Proper
Hum.	Proper
Relations	Proper
Prom	Proper
Mike	Proper
Kent	Proper
Craig	Proper
Sat.	Proper
Ed	Proper
Davison	Proper
Vespers	Proper
swimming	Common
meet	Common
Misalette	Proper
ashes	Common
cars	Common
commonion	Common
extras	Common
lent	Proper
xxx	Common
Mum	Common
duck	Common
UPS	Proper
parcel	Common
post	Common
postage	Common
Eng	Proper
his.	Common
Art.	Common
Brendan	Proper
smackers	Common
Mlle.	Proper
Nance	Proper
80's	Common
Roomers	Common
Tonight	Common
P.M	Common
picnics	Common
parties	Common
P.A.	Proper
experiance	Common
yr.	Common
ROOMATES	Common
RUTH	Proper
RASER	Proper
SALLY	Proper
BROWNING	Proper
karen	Proper
HO	Proper
Schenectady	Proper
N.Y.	Proper
MYSTIC	Proper
CONN.	Proper
HONG	Proper
KONG	Proper
getting	Common
Ruth	Proper
grades	Common
singles	Common
building	Common
inspector	Common
Dory	Proper
Streett	Proper
single	Common
commate	Common
hints	Common
maid	Common
Core	Proper
crap	Common
hooks	Common
flashlights	Common
nylons	Common
STUDY	Common
LAMP	Common
DANGER	Common
LIGHTS	Common
STUDYING	Common
VICTOR	Proper
PINKERTON	Proper
GUARDS	Common
CAMPUS	Common
TOWNIES	Common
WINDOWS	Common
SPRING	Common
TERM	Common
SCREENS	Common
BEE	Common
NEST	Common
BED	Common
PARTY	Common
TOMORROW	Common
NIGHT	Common
prep	Common
ADVANTAGE	Common
YEAR	Common
ABBEY	Proper
MRS.	Proper
ABBOT	Proper
HOUSEMOTHER	Common
LIFE	Common
Luv	Common
Lucy	Proper
THINGS	Common
HISTORY	Common
NOTEBOOK	Common
SECTIONS	Common
MAPS	Common
NOTES	Common
PRICE	Common
OFFER	Common
MISS	Proper
MUCK	Proper
A-	Common
Eau	Proper
Gallie	Proper
Fla.	Proper
Delivery	Proper
blocks	Common
grounds	Common
well	Common
phoneering	Common
Scribners	Proper
oclock	Common
weeds	Common
colors	Common
cardinal	Common
conclave	Common
crows	Common
mocking	Common
oak	Common
cat	Common
Spot	Proper
Shag	Proper
rabbits	Common
armadilla	Common
hoeing	Common
vigor	Common
try	Common
scripts	Common
MULES	Proper
MEN	Proper
Jet	Proper
Base	Proper
Cocoa	Proper
Guided	Proper
Missile	Proper
Lansing	Proper
Gleason	Proper
landlord	Common
neighbors	Common
jungle	Common
compliment	Common
dairy	Common
load	Common
compost	Common
possibilities	Common
tons	Common
tin	Common
bottles	Common
premises	Common
block	Common
radios	Common
oaks	Common
palms	Common
Burroughs	Proper
script	Common
Ottley	Proper
temptation	Common
Evening	Proper
Post	Proper
photographer	Common
dungarees	Common
Hibbs	Proper
magazine	Common
SEP	Proper
Taft	Proper
groceries	Common
slacks	Common
downtown	Common
Zora	Proper
visa	Common
snags	Common
achievement	Common
robotics	Common
teenagers	Common
medal	Common
FIRST	Proper
Challenge	Proper
Robot	Proper
Daughters	Proper
visas	Common
Donald	Proper
Trump	Proper
Muslims	Proper
Ambassador	Proper
Hamdullah	Proper
Mohib	Proper
Afghanistan	Proper
Navy	Proper
Inspiration	Proper
Recognition	Proper
Technlogy	Proper
Kamen	Proper
robots	Common
balls	Common
pairs	Common
coach	Common
Alireza	Proper
Mehraban	Proper
matchup	Common
robot	Common
Idea	Proper
Armenia	Proper
Afghans	Proper
Rodaba	Proper
Noori	Proper
km	Common
Herat	Proper
Kabul	Proper
territory	Common
Taliban	Proper
Council	Proper
interplay	Common
Homeland	Proper
Departments	Proper
parole	Common
entry	Common
criticism	Common
ban	Common
hostility	Common
privacy	Common
Sudan	Proper
Iran	Proper
Libya	Proper
Yemen	Proper
refugees	Common
refugee	Common
Hope	Proper
Robogee	Proper
Morocco	Proper
Estonia	Proper
aspirations	Common
seekers	Common
coast	Common
fishermen	Common
Aceh	Proper
Indonesia	Proper
Fuad	Proper
Basya	Proper
spokesman	Common
military	Common
fisherman	Common
warship	Common
Bangladeshis	Proper
Rohingya	Proper
minority	Common
Myanmar	Proper
migrants	Common
AFP	Proper
Amin	Proper
navy	Common
Minister	Proper
Najib	Proper
Razak	Proper
Thailand	Proper
trafficking	Common
smugglers	Common
Kerry	Proper
Secretary	Proper
housing	Common
Rathke	Proper
Spokesperson	Common
rescue	Common
Ahmed	Proper
Mohamed	Proper
Irving	Proper
Barack	Proper
Facebook	Proper
Zuckerberg	Proper
Yesterday	Common
VIP	Common
Fair	Proper
dignitaries	Common
tweet	Common
bomb	Common
Police	Proper
Images	Common
Deseret	Proper
hashtag	Common
#IStandWithAhmed	Proper
Straits	Proper
academic	Common
Marc	Proper
Lamont	Proper
Hill	Proper
#istandwithahmed	Proper
punishment	Common
incarceration	Common
outreach	Common
finalists	Common
View	Common
Co-founder	Common
Sergey	Proper
Brin	Proper
El	Proper
Hassan	Proper
U.N.	Proper
Arlington	Proper
Amneh	Proper
Jafari	Proper
hastag	Common
Islamophobia	Common
@POTUS	Proper
Islamic	Proper
Alia	Proper
Salem	Proper
Student	Proper
Sehar	Proper
Memon	Proper
feedback	Common
Mecca	Proper
crane	Common
collapse	Common
pilgrims	Common
Mosque	Proper
storm	Common
Arabia	Proper
Authority	Proper
Suleiman	Proper
Amr	Proper
Ikhbariya	Proper
casualties	Common
Photos	Common
mosque	Common
Khaled	Proper
Maeena	Proper
Gazette	Proper
toll	Common
pilgrimage	Common
Islam	Proper
duty	Common
crowd	Common
pilgrimages	Common
Scientology	Proper
defector	Common
reports	Common
Org	Proper
Montalvo	Proper
Blown	Proper
Good	Proper
Headley	Proper
Rathbun	Proper
US$	Common
bail	Common
drives	Common
zip	Common
contract	Common
Ron	Proper
Hubbard	Proper
lifetimes	Common
Members	Proper
lifestyle	Common
Freedom	Common
defectors	Common
Devocht	Proper
conclusion	Common
lies	Common
Florida	Proper
Kendrick	Proper
Moxon	Proper
bars	Common
E-meter	Proper
detective	Common
Sheriff	Proper
investigator	Common
Towers	Proper
anti-christ	Common
Whitmore	Proper
representative	Common
LA	Proper
theft	Common
sheriff	Common
station	Common
lobby	Common
L.A.	Proper
crime	Common
musician	Common
Tiziano	Proper
Lugli	Proper
Jason	Proper
Beghe	Proper
financing	Common
penitentiary	Common
sins	Common
lifehood	Common
slavery	Common
taste	Common
pockets	Common
politicians	Common
Hong	Proper
Kong	Proper
turnout	Common
voters	Common
camp	Common
constituencies	Common
seats	Common
veto	Common
third	Common
reforms	Common
council	Common
campus	Common
Election	Common
Results	Common
Eddie	Proper
Chu	Proper
vote	Common
constituency	Common
Territories	Proper
pan-democrat	Common
votes	Common
candidates	Common
Cheng	Proper
Chung	Proper
tai	Proper
Passion	Proper
democracy	Common
Kwok	Proper
Ka-ki	Proper
Wan	Proper
Tien	Proper
DAB	Proper
Chan	Proper
Leung	Proper
Che	Proper
cheung	Proper
FTU	Proper
Mak	Proper
Junius	Proper
Ho	Proper
Lee	Proper
Cheuk	Proper
yan	Proper
Labour	Proper
Frederick	Proper
Fung	Proper
ADPL	Proper
NPP	Proper
Quat	Proper
councillors	Common
Alvin	Proper
Yeung	Proper
Fernando	Proper
Cheung	Proper
Raymond	Proper
Power	Common
hung	Proper
LSD	Proper
Pan	Common
Lam	Proper
ting	Proper
Youngspiration	Proper
Baggio	Proper
newcomers	Common
Gary	Proper
Eunice	Proper
Yung	Proper
Neo	Proper
Democrats	Proper
leadership	Common
defeat	Common
Regina	Proper
Ip	Proper
Island	Proper
pro-Beijing	Proper
Wai-keung	Proper
Horace	Proper
Demosisto	Proper
victory	Common
elects	Common
Hui	Proper
Chi-fung	Proper
Tanya	Proper
veteran	Common
Cyd	Proper
Ann	Proper
Chiang	Proper
Kowloon	Proper
Priscilla	Proper
BPA	Proper
Claudia	Proper
Mo	Proper
Wong	Proper
Pik-wan	Proper
activists	Common
Siu-lai	Proper
Yau	Proper
Wai-ching	Proper
politician	Common
Proletariat	Proper
kin	Proper
councillor	Common
Or	Proper
Nonpartisan	Common
Tse	Proper
Chi-wai	Proper
Jeremy	Proper
Tam	Proper
tat	Proper
Yiu-chung	Proper
NWSC	Proper
Second	Proper
Super	Proper
Kwong	Proper
Chun	Proper
yu	Proper
pan-democrats	Common
To	Proper
Starry	Proper
Holden	Proper
Chow	Proper
hing	Proper
Shiu	Proper
Ka-chun	Proper
Social	Proper
Welfare	Proper
independent	Common
Yiu	Proper
Surveying	Proper
Planning	Proper
Landscape	Proper
elections	Common
polling	Common
Taikoo	Proper
queues	Common
ballot	Common
Expo	Proper
Toronto	Proper
convention	Common
Metro	Proper
genres	Common
comics	Common
corners	Common
facility	Common
vendors	Common
celebrity	Common
Hamill	Proper
Margaret	Proper
Atwood	Proper
organizations	Common
costumes	Common
Booker	Proper
winner	Common
Angel	Proper
Catbird	Proper
illustrator	Common
Johnnie	Proper
farewell	Common
Conroy	Proper
Joker	Proper
Ubisoft	Proper
PlayStation	Proper
VR	Proper
attendees	Common
demonstration	Common
Arkham	Proper
elevator	Common
Bruce	Proper
Wayne	Proper
manor	Common
Bat	Proper
Cave	Proper
murder	Common
Nightwing	Proper
Arena	Proper
Esports	Proper
gamers	Common
rounds	Common
stands	Common
matches	Common
finals	Common
Cloud9	Proper
Immortals	Proper
Brazil	Proper
Counter-Strike	Proper
Offensive	Proper
Gameplay	Common
rush	Common
Playstation	Proper
Displays	Common
garrison	Common
Legion	Proper
Make	Proper
Wish	Proper
Volunteer	Common
raffles	Common
Ontario	Proper
Ghostbusters	Proper
Who	Proper
Klingon	Proper
Assault	Proper
Group	Proper
Brampton	Proper
Spider	Proper
Gwen	Proper
Symbiote	Proper
Spidey	Proper
booth	Common
showdown	Common
Stormtroopers	Common
five	Common
Cosplay	Proper
craftsmanship	Common
Mickey	Proper
Katherinator	Proper
outfits	Common
parade	Common
halls	Common
cross-section	Common
eras	Common
scratch	Common
cosplayer	Common
gardens	Common
forearm	Common
torso	Common
Superheroes	Common
Widow	Proper
Digimon	Proper
Digi	Proper
Anderson	Proper
Video	Common
Cassandra	Proper
Peekaboo	Proper
Fawn	Proper
Zealand	Proper
flag	Common
Flag	Proper
Consideration	Proper
Project	Proper
conferences	Common
roadshows	Common
Christchurch	Proper
Herald	Proper
Emeritus	Proper
Burrows	Proper
chairman	Common
twelve	Common
kits	Common
referendums	Common
www.flag.govt.nz	Proper
www.standfor.co.nz	Proper
Names	Common
pole	Common
monument	Common
Wellington	Proper
Prime	Proper
Key	Common
rationale	Common
Mr	Proper
Waitangi	Proper
referendum	Common
Zealander	Common
verdict	Common
NZ	Proper
poll	Common
quarter	Common
decrease	Common
Voters	Common
Hackers	Common
posting	Common
Anonymous	Proper
Insurgency	Proper
Wiki	Proper
spinoff	Common
4chan	Proper
Scientologist	Proper
Cruise	Proper
requests	Common
Gawker.com	Proper
Ingram	Proper
Globe	Proper
Mail	Proper
posters	Common
skirmish	Common
newsgroups	Common
alt.religion.scientology	Common
documents	Common
Lawsuits	Common
computers	Common
obsession	Common
insurgency	Common
blogger	Common
Anon	Proper
Gigaloader	Proper
homepage	Common
anarchy	Common
scientology	Common
pigmy	Common
GMT	Common
Posts	Common
critic	Proper
Operation	Proper
Clambake	Proper
denial	Common
Scientology.org	Proper
newsgroup	Common
attacks	Common
Traffic	Common
fold	Common
visits	Common
Hitwise	Proper
Lifestyle	Proper
Religion	Common
category	Common
Explorer	Proper
IE9	Proper
browser	Common
IE6	Proper
Countdown	Proper
IE	Proper
goodbye	Common
Mozilla	Proper
Firefox	Proper
rival	Common
Chrome	Proper
PC	Proper
Safari	Proper
blip	Common
pages	Common
markup	Common
HTML	Proper
vulnerabilities	Common
Secunia.com	Proper
threats	Common
durability	Common
XP	Proper
usefulness	Common
Valeska	Proper
Freewinds	Proper
Bonaire	Proper
teenager	Common
passport	Common
engine	Common
ex-husband	Common
Jaquier	Proper
Clearwater	Proper
am	Common
midnight	Common
removal	Common
asbestos	Common
confrontation	Common
Rehabilitation	Proper
Force	Proper
Sydney	Proper
retreat	Common
Corporation	Proper
allegations	Common
labour	Common
Korea	Proper
Yonhap	Proper
agency	Common
KCNA	Proper
alert	Common
maniacs	Common
DPRK	Proper
shells	Common
KPA	Proper
pretext	Common
shell	Common
Jong	Proper
un	Proper
commander	Common
wartime	Common
loudspeaker	Common
Commanders	Common
warfare	Common
broadcast	Common
counteractions	Common
injuries	Common
Yeoncheon	Proper
dozens	Common
loudspeakers	Common
lull	Common
broadcasts	Common
militaries	Common
Lantern	Proper
Taipei	Proper
Taiwan	Proper
Kai	Proper
Shek	Proper
Memorial	Proper
Hau	Proper
Lung	Proper
switch	Common
lantern	Common
park	Common
centerpiece	Common
concert	Common
pig	Common
fog	Common
laser	Common
festival	Common
zodiac	Common
luck	Common
festivals	Common
celebrations	Common
circumference	Common
counties	Common
lanterns	Common
Tourism	Proper
entrance	Common
swords	Common
devil	Common
transportation	Common
hubs	Common
subway	Common
exodus	Common
crowds	Common
NTU	Proper
Hospital	Proper
Shandao	Proper
stops	Common
photographers	Common
Reports	Common
questionnaire	Common
Braverman	Proper
Sunak	Proper
Border	Proper
vessel	Common
HMC	Proper
Searcher	Proper
Solent	Proper
Brian	Proper
Burnell	Proper
asylee	Common
hopefuls	Common
Eritrea	Proper
Rishi	Proper
backlog	Common
document	Common
explanation	Common
deadline	Common
extensions	Common
Officials	Common
Boris	Proper
amnesty	Common
Yvette	Proper
Cooper	Proper
Albania	Proper
Commissioner	Proper
Refugees	Proper
agreements	Common
gangs	Common
crossings	Common
Figures	Common
migration	Common
claimants	Common
scheme	Common
Gérald	Proper
Darmanin	Proper
Suella	Proper
GB	Proper
towns	Common
duties	Common
harbouring	Common
receipt	Common
gain	Common
immigration	Common
barrister	Common
Yeo	Proper
Immigrants	Proper
campaigner	Common
Caitlin	Proper
Boswell	Proper
refuge	Common
leak	Common
CEO	Proper
Refugee	Proper
Enver	Proper
Solomon	Proper
Moves	Common
hurdles	Common
worry	Common
Questions	Common
update	Common
meantime	Common
deals	Common
debutants	Common
Panama	Proper
Tunisia	Proper
Nizhny	Proper
Novgorod	Proper
Shin-Wook	Proper
Marcus	Proper
Berg	Proper
Joo-Ho	Proper
Min-Woo	Proper
scoring	Common
Hwang	Proper
Hee-Chan	Proper
foul	Common
penalty	Common
referee	Common
Aguilar	Proper
Andreas	Proper
Granqvist	Proper
header	Common
left	Common
Budweiser	Proper
Fisht	Proper
Romelu	Proper
Lukaku	Proper
Yannick	Proper
Carrasco	Proper
Dries	Proper
Mertens	Proper
debutans	Common
scoreboard	Common
volley	Common
Belgians	Proper
Murillo	Proper
Thibaut	Proper
Courtois	Proper
Bruyne	Proper
assist	Common
Eden	Proper
Hazard	Proper
Nacer	Proper
Chadli	Proper
Axel	Proper
Witsel	Proper
Hernan	Proper
Dario	Proper
Volgograd	Proper
Jesse	Proper
Lingard	Proper
Stones	Proper
goalkeeper	Common
Mouez	Proper
Hassen	Proper
Farouk	Proper
Mustapha	Proper
kick	Common
defender	Common
Kyle	Proper
Walker	Proper
Ferjani	Proper
Sassi	Proper
Nabil	Proper
Maaloul	Proper
draw	Common
stampede	Common
Plains	Proper
Arafat	Proper
Ministry	Proper
Muslim	Proper
Jamarat	Proper
Bridge	Proper
pillar	Common
stoning	Common
Satan	Proper
rites	Common
luggage	Common
bus	Common
bottleneck	Common
pillars	Common
faith	Common
safeguards	Common
pilgrams	Common
crush	Common
cameras	Common
personnel	Common
stampedes	Common
Ghaza	Proper
Hotel	Proper
Masjid	Proper
Haram	Proper
resistance	Common
Instituto	Proper
Gonzaga	Proper
Milan	Proper
Friedrichstrasse	Proper
Cassation	Proper
Municipality	Proper
Livorno	Proper
Requests	Common
Bogliasco	Proper
Genova	Proper
deputies	Common
Movimento	Proper
Stelle	Proper
M5S	Proper
Lombardy	Proper
Luca	Proper
Pastorino	Proper
refusals	Common
nursery	Common
retirement	Common
administrations	Common
Supreme	Proper
Santo	Proper
Spirito	Proper
Immacolata	Proper
Tuscany	Proper
euros	Common
arrears	Common
it	Proper
tax	Common
ICI	Proper
IMU	Proper
Monti	Proper
criterion	Common
Stefania	Proper
Giannini	Proper
Claudio	Proper
Vincenti	Proper
undersecretary	Common
association	Common
Undersecretary	Proper
Toccafondi	Proper
fees	Common
Roberto	Proper
Maroni	Proper
counter-measures	Common
CEI	Proper
Italian	Proper
Episcopal	Proper
Nunzio	Proper
Galantino	Proper
ideology	Common
supporters	Common
secularist	Common
MicroMega	Proper
judgement	Common
Rationalist	Proper
Atheists	Proper
Agnostics	Proper
UAAR	Proper
petition	Common
signatures	Common
exhibits	Common
Portrait	Common
Hopper	Proper
Rider	Proper
Polaroids	Common
USI	Proper
Andy	Proper
exhibit	Common
prints	Common
Indiana	Proper
Miharris	Proper
Acphillips	Proper
Evansville	Proper
donor	Common
reporters	Common
donors	Common
organizers	Common
gelatin	Common
Kristin	Proper
Wilkins	Proper
curator	Common
exhibition	Common
Audio	Common
Jkthom	Common
McCutchan	Proper
Pace	Proper
Galleries	Proper
Legacy	Proper
Kristen	Proper
photography	Common
Collections	Common
Kathryn	Proper
artifacts	Common
Photographs	Proper
Prints	Proper
Collection	Proper
Snbehnke	Proper
donation	Common
anniversary	Common
K.C.	Proper
Maurer	Proper
treasurer	Common
Mauer	Proper
stipulation	Common
Polaroid	Proper
Tang	Proper
Teaching	Proper
Gallery	Proper
Skidmore	Proper
Saratoga	Proper
Steichen	Proper
Leigh	Proper
Block	Proper
Northwestern	Proper
Evanston	Proper
Illinois	Proper
Weatherspoon	Proper
Greensboro	Proper
attendance	Common
Elaine	Proper
Gustafon	Proper
Duke	Proper
Chapel	Proper
Superstars	Common
celebrities	Common
UNC	Proper
Truman	Proper
Capote	Proper
songwriter	Common
Carly	Proper
shots	Common
passion	Common
Rhodes	Proper
Duran	Proper
Jann	Proper
Wenner	Proper
Stone	Proper
Carlo	Proper
Benedetti	Proper
Repubblica	Proper
disco	Common
Rubell	Proper
Nat	Proper
Finkelstein	Proper
Makos	Proper
Felice	Proper
Quinto	Proper
Vitas	Proper
Gerulaitis	Proper
tennis	Common
Nicklaus	Proper
golf	Common
designer	Common
Halston	Proper
unknowns	Common
Cynthia	Proper
Thompson	Proper
Fayetteville	Proper
documentation	Common
glimpse	Common
touchstones	Common
worship	Common
buzzwords	Common
Pop	Common
Marilyn	Proper
sixties	Common
non-art	Common
Braysmith	Proper
associate	Common
fascination	Common
Ansel	Proper
Adams	Proper
Chuck	Proper
Mapplethorpe	Proper
Helmut	Proper
booths	Common
paint	Common
Annie	Proper
Oakley	Proper
Cowboys	Proper
businessperson	Common
salesman	Common
Kiara	Proper
Perkins	Proper
Allton	Proper
instructor	Common
Zeitgeist	Common
diety	Common
installation	Common
helium	Common
Elements	Common
touches	Common
refreshment	Common
Kool	Proper
Aid	Proper
tables	Common
gumball	Common
bands	Common
Velvet	Proper
wig	Common
instant	Common
Exhibit	Common
goers	Common
mobiles	Common
lesson	Common
reuse	Common
snap	Common
Scientists	Common
warming	Common
ozone	Common
crops	Common
Colorado	Proper
Sheffield	Proper
wheat	Common
rice	Common
maize	Common
soybean	Common
Nature	Common
Climate	Common
Change	Proper
yields	Common
scenarios	Common
coauthor	Common
Colette	Proper
Heald	Proper
Huffington	Proper
projections	Common
undernourishment	Common
covariation	Common
estimation	Common
pollutants	Common
agriculture	Common
NCLAN	Proper
AS	Proper
Heagle	Proper
dicot	Common
cotton	Common
peanut	Common
monocot	Common
sorghum	Common
corn	Common
dioxide	Common
Protection	Proper
floods	Common
droughts	Common
distribution	Common
pests	Common
diseases	Common
cleanup	Common
Ozone	Common
Clean	Proper
Air	Proper
regulations	Common
Croucher	Proper
Service	Common
deities	Common
worshippers	Common
denomination	Common
Greeks	Proper
gods	Common
Zeus	Proper
Hera	Proper
Poseidon	Proper
Aphrodite	Proper
Athena	Proper
religions	Common
Wicca	Proper
polytheism	Common
alcoholics	Common
cop	Common
blowback	Common
alcoholism	Common
alcohol	Common
sugar	Common
suspicion	Common
addictions	Common
substance	Common
urges	Common
Problem	Common
gambling	Common
urge	Common
playing	Common
isolation	Common
mood	Common
swings	Common
exclusion	Common
Statistical	Proper
Manual	Proper
Disorders	Proper
gaming	Common
disorder	Common
ballroom	Common
dancing	Common
disorders	Common
Addiction	Proper
sorts	Common
chalk	Common
dependance	Common
washer	Common
cats	Common
Cats	Common
alcoholic	Common
neurobiology	Common
treatments	Common
dose	Common
SSRIs	Common
serotonin	Common
reuptake	Common
inhibitors	Common
quantification	Common
neuroimaging	Common
OCD	Proper
DreamWorks	Proper
vibe	Common
vial	Common
Pixar	Proper
voicemail	Common
Shrek	Proper
Starbucks	Proper
Ahab	Proper
revenge	Common
bear	Common
bears	Common
tale	Common
dick	Common
waving	Common
testosterone	Common
castle	Common
manhood	Common
Jonesy	Proper
stick	Common
tone	Common
Jeopardy	Proper
Tropic	Proper
Thunder	Proper
Kind	Common
Brenda	Proper
Chapman	Proper
Andrews	Proper
animation	Common
Beauty	Proper
Beast	Proper
shit	Common
oversight	Common
blogs	Common
nerds	Common
animators	Common
Judd	Proper
Apatow	Proper
monologue	Common
Jimmy	Proper
Fallon	Proper
workday	Common
Anne	Proper
off-	Common
bookings	Common
desks	Common
vocabulary	Common
Late	Proper
packet	Common
sketch	Common
Conan	Proper
Leno	Proper
Lorne	Proper
Michaels	Proper
standup	Common
chops	Common
specifics	Common
GPS	Common
punchlines	Common
improv	Common
collaborator	Common
performer	Common
flop	Common
train	Common
forefront	Common
hyperbole	Common
OpenAI	Proper
ChatGPT	Proper
Bard	Proper
Voltage	Proper
Model	Proper
LLMs	Common
paperclips	Common
preconception	Common
Trek	Proper
Hal	Proper
LLM	Common
shedload	Common
inhaling	Common
objections	Common
EU	Proper
stances	Common
transparency	Common
damn	Common
permissions	Common
Altman	Proper
Bankman	Proper
Fried	Proper
crypto	Common
grifter	Common
flags	Common
Corbyn	Proper
searchability	Common
novella	Common
Caleb	Proper
Wheeler	Proper
Branson	Proper
sketchbook	Common
post-production	Common
wavelength	Common
chapters	Common
muster	Common
Malardians	Proper
PDF	Common
projectlondonmovie.com	Proper
links	Common
novelists	Common
specialists	Common
Chorus	Proper
soundtrack	Common
Hobbit	Proper
Kickstarter	Proper
conventions	Common
GenCon	Proper
screener	Common
airfare	Common
grassroots	Common
Pax	Proper
GeekSeekers	Proper
Chop	Proper
Socky	Proper
Boom	Proper
Gamers	Proper
Jen	Proper
virus	Common
coronavirus	Common
viruses	Common
SARS	Proper
MERS	Proper
SARS-CoV-2	Proper
Covid	Proper
flu	Common
pandemic	Common
proportion	Common
estimates	Common
keeping	Common
antivaxxers	Common
guesswork	Common
influenza	Common
crash	Common
sequencing	Common
disease	Common
trials	Common
Klain	Proper
Ebola	Proper
czar	Common
doses	Common
Petri	Proper
ninth	Common
Assembly	Proper
civilization	Common
fulfilment	Common
aspiration	Common
integration	Common
capacities	Common
Istanbul	Proper
Summit	Proper
deepening	Common
summit	Common
negotiations	Common
Charter	Proper
freedoms	Common
commitment	Common
Cooperation	Proper
programmes	Common
minorities	Common
committees	Common
treaties	Common
guardians	Common
signatory	Common
Millennium	Proper
Declaration	Proper
Development	Proper
Goals	Proper
strategy	Common
per	Common
assistance	Common
Euro	Proper
motto	Common
corridors	Common
investment	Common
OSCE	Proper
Institutions	Proper
Human	Proper
ODIHR	Proper
partnership	Common
initiatives	Common
strengthening	Common
telecommunications	Common
Kosovo	Proper
Interim	Proper
Mission	Proper
UNMIK	Proper
Soren	Proper
Jessen	Proper
Petersen	Proper
Representative	Proper
ministries	Common
g0v	Proper
O	Common
PM	Common
balconies	Common
IoT	Proper
devices	Common
ledger	Common
UN	Proper
nodes	Common
precision	Common
sensors	Common
divide	Common
mountains	Common
AirBox	Proper
drones	Common
turbines	Common
generators	Common
GitHub	Proper
Raspberry	Proper
Pi	Proper
code	Common
CI.taiwan.gov.tw	Proper
earthquake	Common
prevention	Common
CI	Proper
Intelligence	Proper
Innovation	Proper
Bio	Proper
biomed.taiwan	Proper
bio	Common
med	Common
Biomed	Proper
ministry	Common
municipality	Common
SDGs	Proper
jurisdictions	Common
partnerships	Common
innovations	Common
colonizers	Common
co-creators	Common
cabinet	Common
IT	Common
ICT	Proper
transformation	Common
Beings	Proper
singularity	Common
plurality	Common
Tryst	Common
Destiny	Common
Jawaharlal	Proper
Nehru	Proper
Address	Common
tryst	Common
measure	Common
stroke	Common
dawn	Common
striving	Common
grandeur	Common
ideals	Common
misfortunes	Common
triumphs	Common
pains	Common
hearts	Common
sorrrow	Common
ease	Common
resting	Common
pledges	Common
ending	Common
illwill	Common
mansion	Common
slumber	Common
struggle	Common
turning	Common
responsibilities	Common
burdens	Common
Nation	Proper
torch	Common
followers	Common
imprint	Common
humility	Common
tempest	Common
sisters	Common
boundaries	Common
sharers	Common
endeavour	Common
peasants	Common
fullness	Common
obligations	Common
communalism	Common
mindedness	Common
greetings	Common
motherland	Common
homage	Common
Pelosi	Proper
Floor	Proper
Speech	Common
Support	Common
Floyd	Proper
Policing	Proper
MARCH	Proper
RELEASE	Common
Speaker	Proper
Nancy	Proper
Representatives	Proper
Chair	Proper
Madam	Proper
gentleman	Common
Congresswoman	Proper
Karen	Proper
Bass	Proper
reckoning	Common
injustice	Common
brutality	Common
Lives	Proper
Matter	Common
agony	Common
killings	Common
disabilities	Common
Caucus	Proper
Beatty	Proper
Nadler	Proper
policing	Common
racism	Common
Breonna	Proper
Ahmaud	Proper
Arbery	Proper
heroes	Common
Baltimore	Proper
D’Alesandro	Proper
uniform	Common
responders	Common
gratitude	Common
apathy	Common
aisle	Common
misrepresentations	Common
Enforcement	Proper
Executives	Proper
accountability	Common
Biden	Proper
Harris	Proper
committee	Common
Chairman	Proper
COVID	Proper
Philonise	Proper
sadness	Common
forever	Common
Gianna	Proper
Daddy	Proper
summons	Common
anxieties	Common
heartbreaks	Common
endowment	Common
mandate	Common
Pacific	Proper
survivors	Common
Kivu	Proper
traditions	Common
disquiet	Common
Machines	Common
traffickers	Common
demagogues	Common
warlords	Common
fossil	Common
fuels	Common
chaos	Common
A/73/PV.6	Proper
Madagascar	Proper
Maldives	Proper
Congo	Proper
Greece	Proper
Macedonia	Proper
dialogue	Common
tragedy	Common
Envoy	Proper
Damascus	Proper
terrorism	Common
interferences	Common
resolutions	Common
Palestine	Proper
Venezuela	Proper
displacements	Common
Tensions	Common
Gulf	Proper
miscalculation	Common
restraint	Common
non-proliferation	Common
Action	Proper
mediation	Common
surge	Common
diplomacy	Common
crises	Common
investments	Common
peacekeepers	Common
civilians	Common
Peacekeeping	Proper
initiative	Common
troop	Common
aid	Common
shelter	Common
sacrifice	Common
counter-terrorism	Common
extremism	Common
disarmament	Common
agenda	Common
START	Proper
Treaty	Proper
Review	Common
Parties	Proper
Non-Proliferation	Proper
Weapons	Common
peninsula	Common
transition	Common
dysfunction	Common
RECORD	Common
SENATE	Proper
MAIDEN	Common
SPEECH	Common
Front	Proper
citadel	Common
KAMALA	Proper
HARRIS	Proper
oaths	Common
Presidency	Proper
Vice	Proper
Amanda	Proper
Gorman	Proper
inauguration	Common
Mall	Proper
throes	Common
Guardsmen	Proper
oath	Common
mob	Common
criminals	Common
brick	Common
hooligans	Common
adversaries	Common
temple	Common
division	Common
hatred	Common
mistruth	Common
hardship	Common
address	Common
unity	Common
renewal	Common
greatness	Common
goodness	Common
swearing	Common
Chamber	Proper
PADILLA	Proper
OSSOFF	Proper
WARNOCK	Proper
Senators	Proper
KELLY	Proper
HICKENLOOPER	Proper
ascendance	Common
ALEX	Proper
RAFAEL	Proper
Georgia	Proper
segregationists	Common
rabbi	Common
bond	Common
exterminator	Common
housewife	Common
descendant	Common
Holocaust	Proper
awe	Common
reverence	Common
joy	Common
boldness	Common
divisions	Common
Decision	Common
Watergate	Proper
finish	Common
considerations	Common
quitter	Common
instinct	Common
vindication	Common
inflation	Common
noon	Common
Ford	Proper
essential	Common
wounds	Common
bitterness	Common
healing	Common
regret	Common
privilege	Common
enemies	Common
Philadelphia	Proper
Green	Proper
Republicans	Proper
Democrat	Proper
Tale	Proper
speech	Common
mayors	Common
Clark	Proper
Dick	Proper
Dilworth	Proper
Tate	Proper
Hoffman	Proper
Mahady	Proper
Presidents	Common
Barrett	Proper
Bob	Proper
Nix	Proper
Herman	Proper
Toll	Proper
Byrne	Proper
Governor	Proper
adviser	Common
Dave	Proper
key	Common
peacetime	Common
Means	Proper
Open	Proper
coordination	Common
Gakuru	Proper
Tobias	Proper
Schonwetter	Proper
Community	Proper
enthusiasm	Common
Goal	Proper
Kenya	Proper
Senegal	Proper
Nigeria	Proper
CopyrightX	Proper
certificates	Common
Phillip	Proper
Ranja	Proper
Resources	Proper
comprehension	Common
realisation	Common
OER	Proper
re-purposing	Common
cornerstones	Common
continent	Common
Ladies	Common
gentlemen	Common
Term	Proper
Plans	Proper
MTPs	Proper
Pathways	Common
Devolution	Common
Equity	Common
Unity	Common
progression	Common
delivery	Common
flagship	Common
hub	Common
competitiveness	Common
enhancement	Common
MDGs	Proper
Policy	Proper
Guidelines	Proper
alignment	Common
livelihoods	Common
Kenyans	Proper
utilization	Common
convenience	Common
learners	Common
courses	Common
certification	Common
juncture	Common
ladies	Common
Fisher	Proper
Berkman	Proper
graduands	Common
Murungi	Proper
Reporting	Proper
Nairobi	Proper
modalities	Common
penetration	Common
mode	Common
pursuit	Common
Communication	Proper
Hewlett	Proper
SOO	Proper
Remarks	Common
Briefing	Common
Webb	Proper
Telescope	Proper
JULY	Proper
STATEMENTS	Common
RELEASES	Common
Auditorium	Proper
Eisenhower	Proper
P.M.	Common
EDT	Proper
VICE	Proper
PRESIDENT	Proper
unveiling	Common
Administrator	Proper
Nelson	Proper
Alondra	Proper
humans	Common
wonder	Common
marvels	Common
Hubble	Proper
clarity	Common
telescope	Common
allies	Common
cosmos	Common
sunshield	Common
shutters	Common
grain	Common
galaxies	Common
astronomy	Common
ingenuity	Common
Observatory	Proper
Possibilities	Common
Thousands	Common
Tower	Proper
conditioner	Common
ISIS	Proper
victories	Common
Chevrolet	Proper
stupidity	Common
dumping	Common
drugs	Common
rapists	Common
guards	Common
competence	Common
Humvees	Proper
vehicles	Common
GDP	Common
statistic	Common
arsenal	Common
signals	Common
Putin	Proper
clue	Common
Independence	Proper
loyalty	Common
slaves	Common
settlers	Common
prohibition	Common
defendant	Common
judge	Common
administrator	Common
Saltillo	Proper
Settlers	Common
legislature	Common
discontent	Common
abolition	Common
servants	Common
slaveholders	Common
slave	Common
dislike	Common
superiority	Common
Mexicans	Proper
Holley	Proper
Plaskitt	Proper
Domain	Proper
Belief	Common
Texans	Proper
Haden	Proper
Edwards	Proper
Nacogdoches	Proper
Fredonia	Proper
Sabine	Proper
Rio	Proper
Grande	Proper
Rivers	Proper
revolt	Common
revolutionaries	Common
reluctance	Common
independence	Common
Anglo	Proper
settlements	Common
suspension	Common
customs	Common
resumption	Common
tribes	Common
granting	Common
Coahuila	Proper
demands	Common
statehood	Common
y	Common
commerce	Common
regalia	Common
promises	Common
Anahuac	Proper
Lawyer	Common
Travis	Proper
fort	Proper
Gonzales	Proper
Consultation	Proper
Felipe	Proper
Causes	Common
congressman	Common
Tejanos	Proper
Alamo	Proper
intention	Common
defenders	Common
Bowie	Proper
frontiersman	Common
speculator	Common
trader	Common
Davy	Proper
Crockett	Proper
survivor	Common
Fall	Common
Gentilz	Proper
complex	Common
announcement	Common
blinking	Common
interactions	Common
Picture	Proper
Public	Proper
compulsion	Common
Humans	Common
blink	Common
wink	Common
winker	Common
Clifford	Proper
Geertz	Proper
winking	Common
Anthropology	Common
enculturation	Common
punctuation	Common
exclamation	Common
instruction	Common
morality	Common
lessons	Common
happenstance	Common
virtue	Common
assumptions	Common
baby	Common
habits	Common
leisure	Common
hospitality	Common
winks	Common
excellence	Common
keyword	Common
Sikong	Proper
Tu	Proper
n.d.	Common
Xu	Proper
Xishan	Proper
Qinkuang	Proper
zither	Common
harmony	Common
tranquillity	Common
subtlety	Common
Edmund	Proper
Burke	Proper
Immanuel	Proper
Kant	Proper
inquiry	Common
artworld	Common
vol.	Common
DISCOURSE	Common
REMARK	Common
representationalism	Common
formalism	Common
neoformalism	Common
functionalism	Common
institutionalism	Common
historicism	Common
limelight	Common
realism	Common
non-realism	Common
Realism	Common
empiricists	Common
Francis	Proper
Hutcheson	Proper
Hume	Proper
uniformity	Common
libido	Common
physiology	Common
fitness	Common
signal	Common
qualities	Common
Ideas	Common
Uniformity	Common
Variety	Common
Sense	Common
Objects	Common
deformity	Common
Denis	Proper
Dutton	Proper
TED	Proper
Theory	Proper
Learning	Common
Objectives	Common
prototypes	Common
entities	Common
routine	Common
Kahneman	Proper
Cognition	Common
errands	Common
cleaners	Common
grocery	Common
psychologists	Common
workplace	Common
Concepts	Common
Prototypes	Common
impulses	Common
Emotion	Common
Sensations	Common
files	Common
groupings	Common
Piaget	Proper
stages	Common
tolerance	Common
routines	Common
prototype	Common
disobedience	Common
Rosa	Proper
segregation	Common
Montgomery	Proper
Alabama	Proper
Mohandas	Proper
Gandhi	Proper
Mahatma	Proper
Mindset	Common
Discipline	Common
Evernote	Proper
endeavors	Common
industries	Common
venture	Common
farming	Common
sprays	Common
vacuum	Common
cleaner	Common
LINK	Common
LEARNING	Common
bugs	Common
bug	Common
incubation	Common
Entrepreneurs	Common
mindset	Common
obstacle	Common
embarrassment	Common
dilemma	Common
propensity	Common
characteristic	Common
disruptions	Common
innovator	Common
Clayton	Proper
Christensen	Proper
Airbnb	Proper
hotels	Common
travelers	Common
capitalization	Common
Marriott	Proper
Customers	Common
Customer	Common
margins	Common
bedrooms	Common
motor	Common
sharing	Common
programs	Common
Emma	Proper
Fleck	Proper
Penn	Proper
Business	Proper
Journal	Proper
http://pageturnpro2.com.s3-website-us-east-1.amazonaws.com/Publications/201803/15/83956/PDF/131668002208352000_CPBJ033018WEB.pdf	Proper
Katie	Proper
Benner	Proper
Industry	Common
https://www.nytimes.com/2017/04/16/technology/inside-the-hotel-industrys-plan-to-combat-airbnb.html	Proper
Facts	Common
ethics	Common
facts	Common
assumption	Common
non-philosophers	Common
Ruse	Proper
objectivity	Common
realists	Common
naturalism	Common
naturalist	Common
Sharon	Proper
explanations	Common
correctness	Common
epistemology	Common
Enoch	Proper
Beliefs	Common
justification	Common
Klenk	Proper
CONCLUSION	Common
cry	Common
viability	Common
Learner	Common
motivation	Common
grit	Common
Uses	Proper
Gratification	Proper
learner	Common
Resilience	Common
Grit	Common
outlook	Common
trait	Common
tendency	Common
Reynolds	Proper
Credit	Common
DoD	Proper
Flickr	Proper
CC-BY	Proper
Angela	Proper
Duckworth	Proper
cross	Common
GPA	Common
Ivy	Proper
dropout	Common
Spelling	Proper
Bee	Proper
attainment	Common
C.	Proper
Matthews	Proper
Kelly	Proper
Perseverance	Common
doi:10.1037/0022-3514.92.6.1087	Proper
PMID	Proper
aphorisms	Common
essence	Common
Edison	Proper
Genius	Common
inspiration	Common
perspiration	Common
attitude	Common
guarantee	Common
summaries	Common
Americas	Proper
civilizations	Common
lifestyles	Common
Architect	Proper
Capitol	Proper
Beringia	Proper
inhabitants	Common
glaciers	Common
Bering	Proper
Strait	Proper
strait	Common
Asians	Proper
chromosome	Common
credibility	Common
cultures	Common
Aztec	Proper
woodland	Common
populations	Common
Researchers	Common
domestication	Common
sustenance	Common
hunting	Common
gathering	Common
Mesoamerica	Proper
Hemisphere	Proper
Andes	Proper
Amazon	Proper
Basin	Proper
interior	Common
settlement	Common
AMERICANS	Proper
OLMEC	Proper
Mesoamericans	Proper
traits	Common
ritual	Common
bloodletting	Common
Corn	Common
BCE	Common
edifices	Common
calendar	Common
eclipses	Common
solstices	Common
astronomers	Common
planting	Common
harvesting	Common
temples	Common
pyramids	Common
obsidian	Common
jade	Common
clothing	Common
ornaments	Common
cacao	Common
beans	Common
Olmec	Proper
pottery	Common
sculpture	Common
sculptures	Common
pyramid	Common
Venta	Proper
aqueducts	Common
squash	Common
tomatoes	Common
protein	Common
Maya	Proper
serpent	Common
pantheons	Common
Aztecs	Proper
Quetzalcoatl	Proper
Kukulkan	Proper
boulders	Common
figures	Common
MAYA	Proper
highlands	Common
CE	Common
Teotihuacan	Proper
abundance	Common
trades	Common
compounds	Common
Pyramid	Proper
Feathered	Proper
Serpent	Proper
ties	Common
Belize	Proper
Honduras	Proper
Guatemala	Proper
Copan	Proper
Tikal	Proper
Chichen	Proper
Itza	Proper
statues	Common
observatories	Common
drought	Common
Castillo	Proper
Yucatán	Proper
Ken	Proper
1520s	Common
glyphs	Common
codices	Common
singular	Common
codex	Common
Bishop	Proper
Landa	Proper
natives	Common
Terms	Common
cliff	Common
dwellings	Common
Anasazi	Proper
Cherokee	Proper
Inca	Proper
Pueblo	Proper
Ethnocentrism	Common
Relativism	Common
common	Common
universals	Common
etiquette	Common
mug	Common
Grey	Proper
Yak	Proper
Butter	Proper
staple	Common
Tibet	Proper
cuisines	Common
willingness	Common
Bourdain	Proper
fare	Common
cuisine	Common
meat	Common
guinea	Common
cows	Common
pigs	Common
ethnocentrism	Common
sociologist	Common
Graham	Proper
Sumner	Proper
menu	Common
pet	Common
pride	Common
disdain	Common
intentions	Common
imperialism	Common
imposition	Common
savages	Common
governance	Common
plant	Common
varieties	Common
disorientation	Common
sociology	Common
shock	Common
Montana	Proper
Anthropologist	Common
Barger	Proper
Arctic	Proper
snowshoe	Common
mortification	Common
caribou	Common
hunts	Common
tribe	Common
relativism	Common
lens	Common
genital	Common
mutilation	Common
Ethiopia	Proper
Sociologists	Common
Xenocentrism	Common
semester	Common
Spacetime	Common
Gravity	Common
OBJECTIVES	Common
gravity	Common
warping	Common
spacetime	Common
accelerations	Common
beams	Common
arc	Common
Linkages	Common
Mass	Common
roommate	Common
shish	Common
kebabs	Common
fireplace	Common
dorm	Common
Avenue	Proper
p.m.	Common
dimension	Common
subsection	Common
gist	Common
fabric	Common
curving	Common
beam	Common
electron	Common
starship	Proper
Enterprise	Proper
distortion	Common
skyscrapers	Common
amusement	Common
relativity	Common
Positioning	Proper
smartphone	Common
meters	Common
satellites	Common
dwarf	Common
Examples	Common
sheet	Common
diagrams	Common
motorist	Common
stretch	Common
Kansas	Proper
countryside	Common
terrain	Common
axis	Common
Diagram	Common
diagram	Common
Distance	Common
starting	Common
imaginations	Common
comic	Common
Ant	Proper
pebble	Common
paperweight	Common
sag	Common
Measures	Common
Location	Common
measures	Common
quartiles	Common
percentiles	Common
Quartiles	Common
quartile	Common
Q	Proper
percentile	Common
median	Common
quarters	Common
Percentiles	Common
hundredths	Common
colleges	Common
SAT	Proper
halves	Common
Half	Common
IQR	Proper
outliers	Common
outlier	Common
NOTE	Common
abnormality	Common
Prices	Common
salaries	Common
calculation	Common
min	Common
max	Common
vlog	Common
snack	Common
neighbor	Common
backyard	Common
quiet	Common
pimple	Common
patches	Common
makeup	Common
brushes	Common
pillowcases	Common
skincare	Common
hormones	Common
therapy	Common
trauma	Common
therapist	Common
bravery	Common
angle	Common
Conversations	Common
heck	Common
a.m.	Common
gate	Common
filming	Common
deadlines	Common
shower	Common
co-op	Common
workout	Common
Saxby	Proper
massages	Common
bitch	Common
Blue	Proper
cup	Common
chai	Common
latte	Common
Serotonin	Common
caffeine	Common
avocado	Common
sorority	Common
pesto	Common
pasta	Common
penne	Common
peppers	Common
onion	Common
fridge	Common
Ramsay	Proper
chop	Common
vlogs	Common
hustle	Common
like	Common
bait	Common
outro	Common
Jasmine	Proper
socials	Common
@jasthenurse	Proper
shortness	Common
symptoms	Common
symptom	Common
pm	Common
mask	Common
clinics	Common
appointment	Common
e-visit	Common
chills	Common
sinuses	Common
headache	Common
congestion	Common
sneeze	Common
drop	Common
buds	Common
clip	Common
Chips	Common
apple	Common
cider	Common
vinegar	Common
Bath	Proper
Body	Proper
candle	Common
smelling	Common
capability	Common
TikToks	Proper
pickle	Common
juice	Common
Gatorade	Proper
ginger	Common
cayenne	Common
pepper	Common
burning	Common
Truly	Proper
mac	Common
saltiness	Common
textures	Common
Neuroscience	Common
TFs	Common
chem	Common
neuro	Common
bun	Common
neuroscience	Common
semi	Common
Pomodoro	Proper
final	Common
Kat	Proper
Instagram	Proper
Finals	Common
BTS	Proper
Megumi	Proper
donuts	Common
Honey	Common
tulips	Common
Miyuki	Proper
cinnamon	Common
Cinnamon	Common
Caramel	Common
caramel	Common
Basil	Common
lime	Common
blackberry	Common
Blackberry	Common
basil	Common
matters	Common
donut	Common
Shawntas	Proper
wintertime	Common
Coco	Proper
styling	Common
Nourished	Proper
Shawnta	Proper
Curl	Proper
Hold	Proper
Styler	Proper
sesame	Common
seed	Common
rose	Common
coconut	Common
butter	Common
feel	Common
jam	Common
styler	Common
stylers	Common
vitamins	Common
nutrient	Common
botanicals	Common
herbs	Common
horsetail	Common
scent	Common
scents	Common
twist	Common
outs	Common
braid	Common
go's	Common
gel	Common
Gels	Common
curl	Proper
jelly	Common
Jelly	Proper
aloe	Common
rosemary	Common
vera	Common
gels	Common
defining	Proper
jellies	Common
Glacier	Proper
o'clock	Common
shout	Common
Adidas	Proper
Terrex	Proper
hiking	Common
doorstep	Common
shoe	Common
soles	Common
grip	Common
boots	Common
Going	Proper
Road	Proper
waterfall	Common
loop	Common
trailhead	Common
highline	Common
landmark	Common
spray	Common
bush	Common
Canon	Proper
mama	Common
cheers	Common
Guys	Common
beers	Common
Pizza	Proper
Hut	Proper
Columbia	Proper
Falls	Proper
Cheers	Common
Gillette	Proper
Wyoming	Proper
Dakota	Proper
thumbs	Common
lipstick	Common
Target	Proper
lipsticks	Common
Pat	Proper
McGrath	Proper
cosmetics	Common
doorbell	Common
Excitement	Common
Hershey	Proper
spring	Common
cleaning	Common
Faced	Proper
Lipstick	Proper
foundations	Common
pile	Common
Ofra	Proper
Ashton	Proper
Anastasia	Proper
Beverly	Proper
Hills	Proper
Dose	Proper
Colors	Proper
expiration	Common
Color	Common
Halloween	Proper
Black	Proper
Up	Proper
pencils	Common
Decay	Proper
packaging	Common
limit	Common
Jackie	Proper
shoot	Common
pearls	Common
updo	Common
silicone	Common
Marianne	Proper
Orlando	Proper
touch-ups	Common
springs	Common
Mac	Proper
blush	Common
shade	Common
Melon	Proper
Dominique	Proper
Moment	Proper
Palette	Proper
shades	Common
highlight	Common
lash	Common
resort	Common
bathrooms	Common
Mako	Proper
aerosol	Common
poison	Common
ivy	Common
chirping	Common
gator	Common
crocodile	Common
Universal	Proper
tickets	Common
Hogsmeade	Proper
Diagon	Proper
Alley	Proper
wand	Common
shop	Common
owls	Common
wands	Common
Journey	Proper
Hogwarts	Proper
wait	Common
Cauldron	Proper
Saturdays	Common
cereal	Common
Pellegrino	Proper
Nonna	Proper
Lina	Proper
cooking	Common
toss	Common
crust	Common
sauce	Common
Giuliana	Proper
onions	Common
cook	Common
maker	Common
Princess	Proper
Nonna!	Proper
crunch	Common
plates	Common
Justin	Proper
Bieber	Proper
crisp	Common
Salt	Proper
staples	Common
pill	Common
pregnancy	Common
trimester	Common
headspace	Common
hindsight	Common
gloom	Common
midwife	Common
NHS	Proper
checkups	Common
app	Common
mid-September	Proper
appetite	Common
aversions	Common
toast	Common
Pasta	Common
carbs	Common
veg	Common
jet	Common
thingy	Common
lagoon	Common
Bremen	Proper
winery	Common
Sauvignon	Proper
Blanc	Proper
grape	Common
aromas	Common
gooseberry	Common
flavors	Common
palate	Common
acidity	Common
vintage	Common
Chardonnay	Proper
Pinot	Proper
Noir	Proper
rosé	Common
strawberry	Common
limes	Common
lemons	Common
wines	Common
cellar	Common
Signature	Proper
grapes	Common
Pinotage	Proper
Abraham	Proper
Perold	Proper
Stellenbosch	Proper
Hermitage	Proper
stem	Common
Cinsault	Proper
plum	Common
tanins	Common
Shiraz	Proper
palette	Common
Cab	Proper
Cabernet	Proper
backbone	Common
barrel	Common
currant	Common
pencil	Common
shavings	Common
cherries	Common
platter	Common
sips	Common
recap	Common
blend	Common
Merlot	Proper
Franc	Proper
Malbec	Proper
Petit	Proper
Verdot	Proper
Spier	Proper
Mourvèdre	Proper
Viognier	Proper
Chatham	Proper
Islands	Common
Chatnam	Proper
Rekohu	Proper
Moriori	Proper
islands	Common
Date	Proper
Line	Proper
Forties	Proper
civilisation	Common
Pitt	Proper
outcrops	Common
habitat	Common
Maori	Proper
variant	Common
mainland	Common
Chathams	Proper
Napier	Proper
requirements	Common
controls	Common
tourism	Common
flights	Common
camps	Common
Kopinga	Proper
Marae	Proper
transport	Common
shipping	Common
Robin	Proper
Freighters	Proper
Rangatira	Proper
trading	Common
passengers	Common
Freight	Common
Vessels	Common
harbours	Common
policeman	Common
Fisheries	Proper
wharf	Common
berthage	Common
harbour	Common
Motors	Proper
vans	Common
locals	Common
Basalt	Common
carvings	Common
Henga	Proper
Reserve	Proper
Guests	Common
lodge	Common
hr	Common
Access	Common
Hapupu	Proper
Scenic	Proper
Reserves	Proper
Grounds	Proper
rakau	Common
ancestors	Common
attraction	Common
Port	Proper
Hutt	Proper
ports	Common
anchorage	Common
browse	Common
mecca	Common
buffs	Common
Te	Proper
Imi	Proper
treasures	Common
marae	Common
Camps	Common
treasure	Common
Tommy	Proper
Statue	Proper
Tame	Proper
Horomona	Proper
Rehe	Proper
descendants	Common
passing	Common
Manakau	Proper
shores	Common
Erie	Proper
Lakes	Proper
Cuyahoga	Proper
Northeast	Proper
Places	Proper
Almanac	Proper
residents	Common
lakefront	Common
Census	Proper
Bureau	Proper
mid-1980s	Common
Comeback	Proper
revitalization	Common
comeback	Common
moniker	Common
River	Proper
manufacturing	Common
prowess	Common
Roll	Proper
non-locals	Common
riches	Common
beginnings	Common
rebirth	Common
hotspots	Common
Travel	Proper
Leisure	Proper
orchestra	Common
Orchestra	Proper
performing	Common
Playhouse	Proper
Square	Proper
HealthSpace	Proper
R&D	Common
aerospace	Common
aviation	Common
Glenn	Proper
Visitors	Proper
attractions	Common
Omnimax	Proper
Jake	Proper
QuickenLoans	Proper
NBA	Proper
Cavaliers	Proper
Browns	Proper
NFL	Proper
Wolstein	Proper
Vikings	Proper
Cuba	Proper
Visa	Common
CUC	Common
Airport	Proper
airlines	Common
Canadians	Proper
passports	Common
departure	Common
gateway	Common
airports	Common
Cancun	Proper
MXN	Common
USD	Common
airline	Common
airport	Common
authorities	Common
advise	Common
embassy	Common
Consulate	Proper
VisaCuba	Proper
admin	Common
destination	Common
stays	Common
Citizens	Common
Antigua	Proper
Barbuda	Proper
Barbados	Proper
Benin	Proper
Bosnia	Proper
Herzegovina	Proper
CIS	Proper
Ukraine	Proper
Uzbekistan	Proper
Dominica	Proper
Grenada	Proper
Liechtenstein	Proper
Mongolia	Proper
Montenegro	Proper
Namibia	Proper
Singapore	Proper
Slovakia	Proper
Kitts	Proper
Nevis	Proper
Lucia	Proper
Vincent	Proper
Grenadines	Proper
Serbia	Proper
Turkmenistan	Proper
Aeromexico	Proper
departures	Common
ATM	Common
Havana	Proper
Bergen	Proper
Paramus	Proper
NJ	Proper
retail	Common
corridor	Common
transplants	Common
immigrants	Common
restaurants	Common
storefronts	Common
Hudson	Proper
skyline	Common
fireworks	Common
stores	Common
buses	Common
Edgewater	Proper
Englewood	Proper
Cliffs	Proper
Cliffside	Proper
Leonia	Proper
jitney	Common
Bus	Proper
Weehawken	Proper
Newark	Proper
LaGuardia	Proper
Teterboro	Proper
JFK	Proper
Westchester	Proper
Episcopalian	Proper
highrise	Common
intersections	Common
plenty	Common
maids	Common
lee	Proper
roadways	Common
port	Common
taxi	Common
Lemoine	Proper
tel	Common
Babe	Proper
Plaza	Proper
W	Proper
Taxi	Proper
Blvd	Proper
reconstruction	Common
encampment	Common
greenery	Common
displays	Common
Terrace	Proper
re-enactments	Common
GW	Proper
Red	Proper
bicycle	Common
borough	Common
Alter	Proper
Inwood	Proper
supermarkets	Common
Caffasso	Proper
Fairway	Proper
Market	Proper
nail	Common
salons	Common
yogurt	Common
stations	Common
Cafasso	Proper
Ave	Proper
Store	Common
Mon	Proper
Fri	Proper
Sat	Proper
Borders	Proper
liquor	Common
deli	Common
specialty	Common
boutiques	Common
gourmet	Common
caterers	Common
retailers	Common
Plants	Proper
lovers	Common
gardeners	Common
pizzerias	Common
delis	Common
diners	Common
Guadeloupe	Proper
creole	Common
Butterfly	Proper
Caribbean	Proper
department	Common
Puerto	Proper
Rico	Proper
Basse	Proper
Terre	Proper
volcano	Common
Galante	Proper
Saintes	Proper
Haut	Proper
Bas	Proper
bays	Common
Désirade	Proper
Petite	Proper
Cities	Common
Map	Common
Pointe	Proper
à	Proper
Pitre	Proper
suburbs	Common
Gosier	Proper
nightlife	Common
sneakers	Common
des	Proper
Chateaux	Proper
scenery	Common
L'Americano	Proper
bd	Proper
Georges	Proper
Mandel	Proper
salsa	Common
Med	Proper
fax	Common
buffet	Common
windsurf	Common
Morne	Proper
l'eau	Proper
burial	Common
Anse	Proper
pointe	Proper
Vigie	Proper
d'Enfer	Proper
stripe	Common
reefs	Common
geyser	Common
Abymes	Proper
L'instant	Proper
Caraibes	Proper
Baie	Proper
Mahault	Proper
shopping	Common
nightclub	Common
Bik	Proper
Kreyol	Proper
Beau	Proper
Soleil	Proper
Entrance	Common
Drinks	Common
ragga	Common
zouk	Common
rnb	Common
warehouse	Common
destinations	Common
waterfalls	Common
Carbet	Proper
distilleries	Common
tours	Common
rums	Common
drivers	Common
panorama	Common
stomachs	Common
Isfahan	Proper
Persian	Proper
Esfahan	Proper
Tehran	Proper
Province	Proper
Persians	Common
Nesf	Proper
e	Proper
Jahan	Proper
tiling	Common
Persia	Proper
carpets	Common
filigree	Common
textile	Common
mills	Common
boulevards	Common
foothills	Common
Zagros	Proper
Jolfa	Proper
Julfa	Proper
Shah	Proper
Abbas	Proper
1600s	Common
Armenians	Proper
Venice	Proper
Amsterdam	Proper
Churches	Common
Shahid	Proper
Beheshti	Proper
IATA	Proper
IFN	Proper
Mashhad	Proper
Dubai	Proper
Kuwait	Proper
Squares	Common
Naqsh-e	Proper
shah	Proper
imam	Proper
Meidan	Proper
Emam	Proper
mosques	Common
palace	Common
bazaar	Common
Tiananmen	Proper
Beijing	Proper
Heritage	Proper
Site	Proper
Safavid	Proper
holiday	Common
evenings	Common
Chaharbagh	Proper
Boulevard	Proper
Saffavid	Proper
avenue	Common
Meydan	Proper
Kohne	Proper
Shahshahan	Proper
Mosques	Common
Sheikh	Proper
Lotfollah	Proper
Imam	Proper
masterpieces	Common
splendour	Common
Lotf	Proper
Allah	Proper
Bahai	Proper
minarets	Common
Palace	Common
Masjed-e	Proper
Jāmé	Proper
layout	Common
Sassanid	Proper
palaces	Common
Hakim	Proper
portal	Common
Palaces	Common
Ali	Proper
Qapu	Proper
Chehel	Proper
Sotoun	Proper
Ālī	Proper
Qāpū	Proper
floors	Common
niches	Common
Reza	Proper
Abbassi	Proper
pupils	Common
motifs	Common
Hasht	Proper
Behesht	Proper
Paradises	Proper
residence	Common
harem	Common
Columns	Proper
Iranian	Proper
pool	Common
ceremonies	Common
ambassadors	Common
Gardens	Proper
List	Proper
murals	Common
Łódź	Proper
Wootch	Proper
Łódzkie	Proper
Voivodship	Proper
boom	Common
centres	Common
lofts	Common
sightseeing	Common
proximity	Common
Warsaw	Proper
crossroads	Common
motorway	Common
Księży	Proper
Młyn	Proper
Name	Common
dwellers	Common
marketplace	Common
1830s	Common
fortunes	Common
craftsmen	Common
merchants	Common
fairs	Common
residences	Common
expressions	Common
tycoons	Common
influx	Common
Andrzej	Proper
Wajda	Proper
laureate	Common
Władysław	Proper
Reymont	Proper
Third	Proper
Litzmannstadt	Proper
Piotrkowska	Proper
Adolf	Proper
Hitler	Proper
Strasse	Proper
aftermath	Common
machinery	Common
Nazis	Common
liberation	Common
Germans	Proper
panic	Common
Plac	Proper
Wolności	Proper
communism	Common
Kraków	Proper
Wrocław	Proper
emigration	Common
dilapidation	Common
neglect	Common
glance	Common
agglomeration	Common
HollyŁódź	Proper
glitz	Common
glamour	Common
heyday	Common
charm	Common
façades	Common
leitmotivs	Common
Mérida	Proper
Catedral	Proper
Ildefonso	Proper
Zócalo	Proper
Cathedral	Proper
contrasts	Common
malls	Common
Downtown	Proper
plaza	Common
conquistadors	Common
1540s	Common
T'ho	Proper
conquistador	Common
Montejo	Proper
stonework	Common
1800s	Common
1920s	Common
henequen	Common
sisal	Common
trams	Common
Pasejo	Proper
Champs	Proper
Élysées	Proper
twines	Common
ambiance	Common
°	Common
mornings	Common
siesta	Common
breezes	Common
plazas	Common
villages	Common
wildlife	Common
cave	Common
cenote	Common
Tourist	Proper
turismo@merida.gob.mx	Proper
Yucatan	Proper
Su	Proper
Paseo	Proper
Module	Proper
Southwest	Proper
elevation	Common
ft	Common
Sonoran	Proper
Scottsdale	Proper
Tempe	Proper
Glendale	Proper
Peoria	Proper
Chandler	Proper
Gilbert	Proper
Area	Proper
exurbs	Common
Apache	Proper
Fountain	Proper
Creek	Proper
summertime	Common
sunscreen	Common
Verde	Proper
Hohokam	Proper
canal	Common
1860s	Common
reservoirs	Common
irrigation	Common
tens	Common
acres	Common
citrus	Common
Easterners	Common
Midwesterners	Common
metro	Common
summers	Common
winters	Common
30s	Common
norm	Common
Monsoon	Common
rains	Common
lightning	Common
neighborhoods	Common
sunset	Common
sunrise	Common
Maps	Proper
Harbor	Proper
PHX	Proper
Airlines	Proper
Terminals	Common
Terminal	Proper
Gates	Proper
Spirit	Proper
Delta	Proper
Frontier	Proper
Hawaiian	Proper
JetBlue	Proper
Aeroméxico	Proper
Airways	Proper
Volaris	Proper
WestJet	Proper
Buckeye	Proper
Greyhound	Proper
depot	Common
skytrain	Common
44th	Proper
Priest	Proper
Ridge	Proper
Resort	Proper
Deer	Proper
Tatum	Proper
rail	Common
Mesa	Proper
Midtown	Proper
biodiversity	Common
Socotra	Proper
reserve	Common
eco	Common
lodging	Common
accommodations	Common
Hadibo	Proper
Taj	Proper
Hafijj	Proper
conditionting	Common
televisions	Common
refrigerators	Common
campsites	Common
Tourists	Common
camping	Common
packages	Common
runway	Common
harbor	Common
fuel	Common
enthusiasts	Common
monsoon	Common
mid-August	Proper
surfing	Common
Dixam	Proper
Sana'a	Proper
Mukalla	Proper
Yemenia	Proper
Felix	Proper
durations	Common
Sharjah	Proper
Qalansia	Proper
camel	Common
jewel	Common
Arabian	Proper
Hagghier	Proper
limestone	Common
plateau	Common
coastline	Common
dunes	Common
Mountains	Proper
endemics	Common
dragon	Common
bark	Common
elephant	Common
Cucumber	Proper
Tree	Proper
Sydfynske	Proper
Øhav	Proper
Funen	Proper
Archipelago	Proper
islets	Common
Denmark	Proper
hilltops	Common
submersion	Common
flora	Common
fauna	Common
Flora	Common
ornithology	Common
Tern	Proper
kilometers	Common
Shore	Proper
Crabs	Proper
Beach	Proper
Otters	Proper
Seals	Common
badgers	Common
stoats	Common
Harbour	Proper
Porpoise	Proper
Tåsinge	Proper
Langeland	Proper
ferries	Common
Svendborg	Proper
highway	Common
Faaborg	Proper
Odense	Proper
reference	Common
Spodsbjerg	Proper
Tårs	Proper
Lolland	Proper
wallet	Common
kayak	Common
sights	Common
Smack	Proper
Dinghies	Proper
strain	Common
cattle	Common
barges	Common
Øhavet	Proper
smakkecenter	Common
Strynø	Proper
Øhavets	Proper
Smakkecenter	Proper
Brovej	Proper
info@smakkecenter.dk	Proper
Kayak	Proper
archipelago	Common
poles	Common
baggage	Common
forwarding	Common
Heels	Proper
Taasinge	Proper
Vagabond	Proper
Tours	Proper
Tranekær	Proper
trek	Common
guidebook	Common
Danish	Proper
Pamphlets	Common
tips	Common
pdf	Common
Bjerrebyvej	Proper
info@vagabondtours.dk	Proper
Kr	Common
Vindebyørevej	Proper
info@travelheels.dk	Proper
tent	Common
sleeping	Common
cover	Common
tarpaulin	Common
Birkholm	Proper
Ferry	Common
Marstal	Proper
Ærø	Proper
Marina	Proper
º	Common
'	Common
VHF	Common
berths	Common
Depth	Common
Speed	Common
foreigners	Common
fishing	Common
hunter	Common
Pheasant	Common
hare	Common
Respect	Common
Thais	Proper
wai	Common
McDonald	Proper
greeting	Common
Hindu	Proper
inferiors	Common
superiors	Common
offense	Common
Dress	Common
offering	Common
allowance	Common
Westerners	Common
dressers	Common
holes	Common
Pants	Common
blouses	Common
sleeves	Common
tank	Common
tops	Common
straps	Common
spaghetti	Common
laborers	Common
schoolchildren	Common
Flip	Common
flops	Common
sandals	Common
clog	Common
establishments	Common
wats	Common
ankle	Common
polo	Common
dresses	Common
skirts	Common
Shorts	Common
sunbathing	Common
Wat	Proper
Arun	Proper
Bangkok	Proper
Monks	Common
Buddhism	Proper
temptations	Common
Women	Common
layman	Common
merit	Common
Theravada	Proper
disrespect	Common
fakes	Common
Tulsa	Proper
Oil	Proper
Bartlesville	Proper
Ozark	Proper
Plateau	Proper
precipitation	Common
stereotype	Common
Summers	Common
plains	Common
snow	Common
Deco	Proper
barons	Common
mansions	Common
trove	Common
TUL	Proper
sofas	Common
RVS	Proper
Riverside	Proper
passenger	Common
Tulsans	Proper
pedestrian	Common
OK	Proper
Coffeyville	Proper
KS	Proper
Missouri	Proper
Rogers	Proper
Turnpike	Proper
McDonalds	Proper
roadway	Common
Vinita	Proper
Southeast	Proper
Muskogee	Proper
Okmulgee	Proper
Beeline	Proper
Turner	Proper
Cimarron	Proper
Route	Proper
Lines	Proper
Detroit	Proper
Ave.	Proper
grid	Common
freeways	Common
bypasses	Common
Mingo	Proper
Expressway	Proper
Pearl	Proper
Hwy	Proper
Broken	Proper
Arrow	Proper
B.A.	Proper
arterials	Common
Winston	Proper
Yale	Proper
Allegheny	Proper
Braden	Proper
mid-town	Common
Admiral	Proper
Mississippi	Proper
145th	Proper
Place	Proper
designation	Common
Florence	Proper
71st	Proper
Frisco	Proper
railroad	Common
bounds	Common
plat	Common
compass	Common
down	Common
Transit	Proper
Sand	Proper
Sapulpa	Proper
Jenks	Proper
S.	Proper
Denver	Proper
Rivertrail	Proper
Katy	Proper
Trail	Proper
Osage	Proper
rails	Common
OSU	Proper
Skiatook	Proper
NSU	Proper
Riders	Common
contours	Common
depots	Common
riders	Common
bicycling	Common
cathedral	Common
Yorkshire	Proper
Manchester	Proper
Minster	Proper
Eboracum	Proper
Romans	Proper
fortress	Common
Ouse	Proper
Sixth	Proper
Britain	Proper
Britannia	Proper
Constantine	Proper
Jorvik	Proper
Yor-vik	Proper
Viking	Proper
Coppergate	Proper
excavations	Common
charms	Common
explorers	Common
curiosity	Common
Festivals	Common
Angels	Proper
Horse	Proper
Racing	Proper
Ebor	Proper
Race	Proper
Meeting	Proper
Mystery	Common
Plays	Proper
Drink	Common
travellers	Common
motorways	Common
M1	Proper
junction	Common
M18	Proper
A1M	Proper
A64	Proper
A1237	Proper
reaches	Common
Leeds	Proper
A59	Proper
M62	Proper
Liverpool	Proper
A1	Proper
A19	Proper
Tyneside	Proper
Northumberland	Proper
Bootham	Proper
remodelling	Common
junctions	Common
jams	Common
Steps	Common
arrogance	Common
Arrogance	Common
smugness	Common
vulnerability	Common
worldview	Common
Jealousy	Common
anger	Common
Ambiguity	Common
imperfection	Common
certainty	Common
Reality	Common
imperfections	Common
input	Common
friendships	Common
friendship	Common
backgrounds	Common
coolness	Common
chatterbox	Common
rivalries	Common
annoyances	Common
enmities	Common
condemnation	Common
mentality	Common
trophy	Common
Ballet	Common
1600's	Common
clogs	Common
flexibility	Common
basics	Common
positions	Common
Part	Common
slippers	Common
numbness	Common
drawstring	Common
pinkie	Common
fingernail	Common
stickies	Common
leotard	Common
bet	Common
moves	Common
positing	Common
timing	Common
elegance	Common
positioning	Common
mirrors	Common
barre	Common
Methods	Common
Starting	Common
Seeds	Common
herb	Common
Method	Common
seeds	Common
spice	Common
citral	Common
compound	Common
decoration	Common
basils	Common
African	Proper
veins	Common
Thai	Proper
annuals	Common
bushes	Common
frost	Common
almanac	Common
containers	Common
flats	Common
perlite	Common
vermiculite	Common
peat	Common
wrap	Common
sprouts	Common
Flowers	Common
hormone	Common
mold	Common
stalk	Common
Caprese	Proper
salad	Common
mozzarella	Common
refrigerator	Common
towels	Common
lid	Common
blender	Common
Chicken	Common
Biologists	Common
hypnosis	Common
beak	Common
cm	Common
shove	Common
Stress	Common
immobility	Common
prey	Common
opossum	Common
upside	Common
Hypnosis	Common
fainting	Common
stress	Common
Hours	Common
Hens	Common
feathering	Common
preening	Common
laying	Common
Cupcakes	Common
Vanilla	Common
Chocolate	Common
cakes	Common
eggs	Common
cupcake	Common
recipe	Common
icing	Common
Ingredients	Common
Servings	Common
cupcakes	Common
tablespoon	Common
ml	Common
cups	Common
soy	Common
g	Common
flour	Common
teaspoons	Common
powder	Common
teaspoon	Common
vegetable	Common
vanilla	Common
extract	Common
cocoa	Common
Pinch	Common
caster	Common
sunflower	Common
tablespoons	Common
oven	Common
o	Common
muffin	Common
tray	Common
mixer	Common
wire	Common
rack	Common
frosting	Common
skewer	Common
cooling	Common
Tips	Common
lunchboxes	Common
apricot	Common
peach	Common
plus	Common
syrup	Common
walnut	Common
macadamia	Common
nut	Common
oils	Common
Coconut	Common
olive	Common
pantry	Common
neroli	Common
orange	Common
rosewater	Common
blossom	Common
Elevators	Common
prankster	Common
pranks	Common
punch	Common
noises	Common
explosion	Common
elevators	Common
jazz	Common
beast	Common
tarantula	Common
snake	Common
scorpion	Common
Lego	Proper
Twister	Common
mat	Common
Messaging	Common
gal	Common
MSN	Proper
AIM	Proper
Chat	Proper
messaging	Common
creep	Common
Congratulations	Common
flirts	Common
Step	Common
Flirting	Common
Dos	Common
plunge	Common
encounter	Common
flirting	Common
awkwardness	Common
username	Common
pleasantries	Common
suggestions	Common
Manic	Proper
Albatross	Proper
Beatles	Proper
Monroe	Proper
sorrows	Common
launching	Common
hobbies	Common
bourbon	Common
song	Common
rehab	Common
stints	Common
Don'ts	Common
mantra	Common
loathing	Common
compliments	Common
Glowstick	Common
hoaxes	Common
glowstick	Common
cheating	Common
Luminol	Proper
gloves	Common
best	Common
smock	Common
pH	Common
milliliters	Common
liter	Common
mixing	Common
funnels	Common
measuring	Common
basters	Common
luminol	Common
nitrogen	Common
atoms	Common
oxygen	Common
substances	Common
rave	Common
electrons	Common
grams	Common
sodium	Common
carbonate	Common
copper	Common
sulfate	Common
ammonium	Common
funnel	Common
mid-air	Common
graphic	Common
coroner	Common
spy	Common
criminologist	Common
Alfa	Proper
Aesar	Proper
Sigma	Common
Aldrich	Proper
utensil	Common
glowsticks	Common
lids	Common
chemical	Common
Expectations	Common
laboratory	Common
Bird	Common
suffix	Common
plurals	Common
complication	Common
genders	Common
Onomatopoeia	Common
Flap	Common
Accident	Common
alphabets	Common
Characters	Common
Alphabet	Common
Chinese	Proper
strangers	Common
knot	Common
tongue	Common
friend(s)	Common
guidelines	Common
shortcut	Common
connotation	Common
vowels	Common
vowel	Common
acrimony	Common
guess	Common
gibberish	Common
marks	Common
pictographs	Common
proto-language	Common
Possessions	Common
Books	Common
brim	Common
bubble	Common
newsprint	Common
Boxes	Common
mishandling	Common
essentials	Common
toiletries	Common
toilet	Common
snacks	Common
Tape	Common
bottoms	Common
masking	Common
packing	Common
screws	Common
screw	Common
paperwork	Common
superstores	Common
Walmart	Proper
sizes	Common
diaper	Common
houseware	Common
cart	Common
U-haul	Proper
refund	Common
handling	Common
Parachute	Common
skydiving	Common
parachutes	Common
coping	Common
slipstream	Common
chutes	Common
jumper	Common
chute	Common
jump	Common
strap	Common
harness	Common
canopy	Common
obstructions	Common
Alternative	Common
Lack	Common
skydivers	Common
recourse	Common
instructors	Common
goddess	Common
guardian	Common
angel	Common
Jude	Proper
deity	Common
afterlife	Common
landing	Common
rigger	Common
parachute	Common
Kubler	Proper
phases	Common
Warnings	Common
landings	Common
diver	Common
destruction	Common
cranium	Common
demise	Common
procrastinator	Common
procrastination	Common
Side	Common
notebook	Common
sitting	Common
breeze	Common
chores	Common
trash	Common
frenzy	Common
daydreams	Common
Chances	Common
timer	Common
boxing	Common
arrangement	Common
nap	Common
alarm	Common
Muggle	Proper
Quidditch	Proper
JK	Proper
Rowling	Proper
powers	Common
broom	Common
Brooms	Common
hindrance	Common
brooms	Common
quaffle	Common
bludgers	Common
Chasers	Common
hoops	Common
Beaters	Common
bludger	Common
chaser	Common
Keepers	Common
chasers	Common
Keeper	Common
Seekers	Common
snitch	Common
sock	Common
running	Common
seeker	Common
creators	Common
muggle	Common
broomsticks	Common
tailor	Common
muggles	Common
bystander	Common
hockey	Common
bat	Common
wiffle	Common
dodge	Common
capture	Common
Snitch	Common
quidditch	Common
intervals	Common
snitches	Common
IQA	Proper
coin	Common
pitch	Common
Referee	Common
capes	Common
Bludgers	Common
Quaffle	Common
volleyball	Common
Frisbee	Common
soccer	Common
Seeker	Common
Quinoa	Common
Peru	Proper
Incas	Proper
quinoa	Common
grains	Common
emperor	Common
implements	Common
vegetarians	Common
broth	Common
Olive	Common
Stove	Common
Top	Common
strainer	Common
saponins	Common
outside	Common
saucepan	Common
stock	Common
boil	Common
germ	Common
spiral	Common
exterior	Common
bite	Common
fork	Common
Stir	Common
fry	Common
Curry	Common
Cooker	Common
mesh	Common
sieve	Common
cooker	Common
Oven	Common
seive	Common
mushrooms	Common
dish	Common
aluminum	Common
foil	Common
seasonings	Common
Skittles	Proper
Vodka	Common
Serving	Common
mL	Common
Shot	Common
Bottles	Common
Dishwasher	Common
candies	Common
cocktails	Common
rainbow	Common
handle	Common
liters	Common
gallon	Common
candy	Common
ratio	Common
mix	Common
Skittle	Proper
insides	Common
servings	Common
flavor(s)	Common
oz	Common
flavour	Common
filter	Common
bags	Common
skittles	Proper
dishwasher	Common
cheesecloth	Common
muslin	Common
contamination	Common
sourness	Common
softener	Common
dryer	Common
flavoring	Common
limits	Common
intoxication	Common
Coffee	Common